CharacterName|WikiLink
Angus Buchanan|Angus_Buchanan
Bartemius Crouch Junior|Bartemius_Crouch_Junior
Arthur Weasley's brothers|Arthur_Weasley%27s_brothers
Alphard Black|Alphard_Black
Iola Black|Iola_Black
Phineas Black|Phineas_Black
Sirius Black|Sirius_Black
Cedrella Black|Cedrella_Black
Eduardus Limette Black|Eduardus_Limette_Black
Remus Lupin|Remus_Lupin
Edward Lupin|Edward_Lupin
Marius Black|Marius_Black
Andromeda Tonks|Andromeda_Tonks
Edward Tonks|Edward_Tonks
Nymphadora Tonks|Nymphadora_Tonks
Weasley children's cousin|Weasley_children%27s_cousin
Arthur Weasley|Arthur_Weasley
Merope Riddle|Merope_Riddle
Rionach Sayre|Rionach_Sayre
Altheda|Altheda
Amata|Amata
Amata's lover|Amata%27s_lover
Asha|Asha
Britannia|Britannia
Captain of the Brigade of Witch-Hunters|Captain_of_the_Brigade_of_Witch-Hunters
Charlatan|Charlatan
Crapaud|Crapaud
Death (The Tale of the Three Brothers)|Death_(The_Tale_of_the_Three_Brothers)
Count Dracula|Count_Dracula
Evil sorcerer|Evil_sorcerer
Father Christmas|Father_Christmas
Flurry|Flurry
Grenouille|Grenouille
Grumble|Grumble
Dirgah Hagrid|Dirgah_Hagrid
The Hopping Pot|The_Hopping_Pot
King (Babbitty Rabbitty and her Cackling Stump)|King_(Babbitty_Rabbitty_and_her_Cackling_Stump)
Maiden|Maiden
Martin Miggs|Martin_Miggs
Loony Nonby|Loony_Nonby
Old man's donkey|Old_man%27s_donkey
Old man's family|Old_man%27s_family
Peasant woman|Peasant_woman
Peasant woman's granddaughter|Peasant_woman%27s_granddaughter
Babbitty Rabbity|Babbitty_Rabbity
Sabre|Sabre
Sir Luckless|Sir_Luckless
The Maiden's kinsfolk|The_Maiden%27s_kinsfolk
Unidentified Old Man|Unidentified_Old_Man
Warlock (The Warlock's Hairy Heart)|Warlock_(The_Warlock%27s_Hairy_Heart)
The Warlock's friends|The_Warlock%27s_friends
Wee Willykins|Wee_Willykins
Gigantic white worm|Gigantic_white_worm
Wizard (The Wizard and the Hopping Pot)|Wizard_(The_Wizard_and_the_Hopping_Pot)
Wizard's father|Wizard%27s_father
Young woman|Young_woman
Young woman's child|Young_woman%27s_child
Albus Dumbledore|Albus_Dumbledore
Abernathy|Abernathy
Bathilda Bagshot|Bathilda_Bagshot
Cuthbert Binns|Cuthbert_Binns
Bloody Baron|Bloody_Baron
Reginald Cattermole|Reginald_Cattermole
Penelope Clearwater|Penelope_Clearwater
Vincent Crabbe|Vincent_Crabbe
Bartemius Crouch Junior's mother|Bartemius_Crouch_Junior%27s_mother
Gregory Goyle|Gregory_Goyle
Hermione Granger|Hermione_Granger
Percival Graves|Percival_Graves
Gellert Grindelwald|Gellert_Grindelwald
Mafalda Hopkirk|Mafalda_Hopkirk
Bellatrix Lestrange|Bellatrix_Lestrange
Alastor Moody|Alastor_Moody
Red-haired Muggle boy|Red-haired_Muggle_boy
Harry Potter|Harry_Potter
Tom Riddle|Tom_Riddle
Albert Runcorn|Albert_Runcorn
Stanley Shunpike|Stanley_Shunpike
Severus Snape|Severus_Snape
Unidentified little girl|Unidentified_little_girl
Ronald Weasley|Ronald_Weasley
Euan Abercrombie|Euan_Abercrombie
Sakura Akagi|Sakura_Akagi
Zakir Akram|Zakir_Akram
Nick Alas|Nick_Alas
Filemina Alchin|Filemina_Alchin
Christian Alexander|Christian_Alexander
Astrix Alixan|Astrix_Alixan
Brandon Angel|Brandon_Angel
Jada Angela|Jada_Angela
Owen Anthony|Owen_Anthony
Angelina Appleby|Angelina_Appleby
Oona Ballington|Oona_Ballington
Pete Balsall|Pete_Balsall
Allison Barnes|Allison_Barnes
Concepta Battista|Concepta_Battista
Katie Bell|Katie_Bell
Fiona Belmont|Fiona_Belmont
Bem|Bem
Kajol Bhatt|Kajol_Bhatt
Betty Bickering|Betty_Bickering
Hugh Biggs|Hugh_Biggs
Sally Birchgrove|Sally_Birchgrove
Mike Boon|Mike_Boon
Derek (Wizard Card Collectors' Club)|Derek_(Wizard_Card_Collectors%27_Club)
Unidentified Gryffindor boy|Unidentified_Gryffindor_boy
Boy 2|Boy_2
Unidentified Gryffindor boy's friend|Unidentified_Gryffindor_boy%27s_friend
Justine Britnell|Justine_Britnell
Lavender Brown|Lavender_Brown
Cadogan|Cadogan
Richard Carter|Richard_Carter
Stephen Challock|Stephen_Challock
Polly Chapman|Polly_Chapman
Jason Charmer|Jason_Charmer
Liza Cherks|Liza_Cherks
Nina Chibbar|Nina_Chibbar
Brian Cinderford|Brian_Cinderford
Iain Claverdon|Iain_Claverdon
Andrew Cleveley|Andrew_Cleveley
Rachael Codnor|Rachael_Codnor
Angelica Cole|Angelica_Cole
Lydia Cooden|Lydia_Cooden
Ritchie Coote|Ritchie_Coote
Ben Copper|Ben_Copper
Muldoon Cragg|Muldoon_Cragg
Colin Creevey|Colin_Creevey
Dennis Creevey|Dennis_Creevey
Winky Crockett (Gryffindor)|Winky_Crockett_(Gryffindor)
Lisa Cullen|Lisa_Cullen
Haley Dakota|Haley_Dakota
Dan|Dan
Jennifer Dawn|Jennifer_Dawn
Alison Denshaw|Alison_Denshaw
Mary Doyle|Mary_Doyle
Fay Dunbar|Fay_Dunbar
Fay Dunbar's friend|Fay_Dunbar%27s_friend
Edward|Edward
Emily (Gryffindor)|Emily_(Gryffindor)
Entrance Hall Gryffindor prefect|Entrance_Hall_Gryffindor_prefect
Tracie Everson|Tracie_Everson
Rosalyn Ewhurst|Rosalyn_Ewhurst
Natalie Fairbourne|Natalie_Fairbourne
Fat Lady|Fat_Lady
Seamus Finnigan|Seamus_Finnigan
Terrence Fogarty|Terrence_Fogarty
Louise Fontwell|Louise_Fontwell
Sam Fraddon|Sam_Fraddon
Hamish Frater|Hamish_Frater
Riley Frazer|Riley_Frazer
Yann Fredericks|Yann_Fredericks
Vicky Frobisher|Vicky_Frobisher
Chris Garland|Chris_Garland
Ethan Gerard|Ethan_Gerard
Girl who tested Fainting Fancie|Girl_who_tested_Fainting_Fancies
Stephen Gould|Stephen_Gould
Rose Granger-Weasley|Rose_Granger-Weasley
Gryffindor boy who fetched Harry Potter|Gryffindor_boy_who_fetched_Harry_Potter
Gryffindor boy who struggled with the Levitation Charm|Gryffindor_boy_who_struggled_with_the_Levitation_Charm
Unidentified Gryffindor girl (IX)|Unidentified_Gryffindor_girl_(IX)
Unidentified Gryffindor member of Dumbledore's Army|Unidentified_Gryffindor_member_of_Dumbledore%27s_Army
Curious Gryffindor Girl|Curious_Gryffindor_Girl
Gryffindor Wizard's Chess champion|Gryffindor_Wizard%27s_Chess_champion
Godric Gryffindor|Godric_Gryffindor
Rubeus Hagrid|Rubeus_Hagrid
David Hamblin|David_Hamblin
Curt Hanger|Curt_Hanger
Kelly Harborne|Kelly_Harborne
Head of Gryffindor House|Head_of_Gryffindor_House
Ryan Henry|Ryan_Henry
Natalie Holkham|Natalie_Holkham
Thelma Holmes|Thelma_Holmes
Geoffrey Hooper|Geoffrey_Hooper
Carl Hopkins|Carl_Hopkins
Lucy Hurst|Lucy_Hurst
Satoru Iida|Satoru_Iida
Erica J.|Erica_J.
Peter James|Peter_James
Ella Jo|Ella_Jo
Nandini Johar|Nandini_Johar
Angelina Johnson|Angelina_Johnson
Peter Jones|Peter_Jones
Lee Jordan|Lee_Jordan
Timothy Justin|Timothy_Justin
Anjali Kapoor|Anjali_Kapoor
Michael Karume|Michael_Karume
Kellah|Kellah
Sage Kelleen|Sage_Kelleen
Jae Kim|Jae_Kim
Jo King (Gryffindor)|Jo_King_(Gryffindor)
R. J. H. King|R._J._H._King
Andrew Kirke|Andrew_Kirke
Toby Lennox (Gryffindor)|Toby_Lennox_(Gryffindor)
Neville Longbottom|Neville_Longbottom
Aamir Loonat|Aamir_Loonat
Trinity Lynn|Trinity_Lynn
Anita Macduff|Anita_Macduff
Pippa Macmillan|Pippa_Macmillan
Hisana Malachela|Hisana_Malachela
Daphne Maldon|Daphne_Maldon
Unidentified Gryffindor seeker|Unidentified_Gryffindor_seeker
Trev Mallory|Trev_Mallory
Marauders|Marauders
Alexis Marie|Alexis_Marie
Gianna Grace Marie|Gianna_Grace_Marie
Kenny Markham|Kenny_Markham
Angus Matlock|Angus_Matlock
Paul Mawdesley|Paul_Mawdesley
McClaggan|McClaggan
Natalie McDonald|Natalie_McDonald
Joe McGee|Joe_McGee
M. G. McGonagall|M._G._McGonagall
Minerva McGonagall|Minerva_McGonagall
Cormac McLaggen|Cormac_McLaggen
Robin McTighe|Robin_McTighe
Michael|Michael
Eloise Midgen|Eloise_Midgen
Nicholas de Mimsy-Porpington|Nicholas_de_Mimsy-Porpington
Miraphora Mina (Hogwarts student)|Miraphora_Mina_(Hogwarts_student)
Ruth Mina|Ruth_Mina
Anna Mirfield|Anna_Mirfield
Raza Mohammad|Raza_Mohammad
Tatsuya Motoyama|Tatsuya_Motoyama
Kieran Muirhead|Kieran_Muirhead
Ismelda Murk's sister|Ismelda_Murk%27s_sister
Roderick Murphy|Roderick_Murphy
Valeria Myriadd|Valeria_Myriadd
Edith Newton|Edith_Newton
Abigail Nicola|Abigail_Nicola
Amber Noel|Amber_Noel
Phelan Noel|Phelan_Noel
David Nolton|David_Nolton
Mallory Norden|Mallory_Norden
Neil Nuts|Neil_Nuts
Aiden O'Connor|Aiden_O%27Connor
Shelagh O'Dowd|Shelagh_O%27Dowd
Rionach O'Neal|Rionach_O%27Neal
Uric Oapley|Uric_Oapley
Sean Ogbourne|Sean_Ogbourne
Remy Olivier|Remy_Olivier
Kate Olney|Kate_Olney
Steven Osterley|Steven_Osterley
Andrew Owly|Andrew_Owly
Thomas Paley|Thomas_Paley
Julie Parkes|Julie_Parkes
Parvati Patil|Parvati_Patil
Jimmy Peakes|Jimmy_Peakes
Peter Pettigrew|Peter_Pettigrew
Adam Pickering|Adam_Pickering
Podric Piles|Podric_Piles
Wayne Portchester|Wayne_Portchester
Fleamont Potter|Fleamont_Potter
James Potter I|James_Potter_I
James Potter II|James_Potter_II
Lily J. Potter|Lily_J._Potter
Lily L. Potter|Lily_L._Potter
Ernest Prang|Ernest_Prang
Sophia Prickett|Sophia_Prickett
Patricia Rakepick|Patricia_Rakepick
Genevieve Ramsey|Genevieve_Ramsey
Neil Randall|Neil_Randall
Demelza Robins|Demelza_Robins
Barry Rochester|Barry_Rochester
Ashley Sanders|Ashley_Sanders
Selina Sapworthy|Selina_Sapworthy
Andrew Saxby|Andrew_Saxby
Roderick Seaton|Roderick_Seaton
Seventh Floor Gryffindor Prefect|Seventh_Floor_Gryffindor_Prefect
Jackson Sheppard|Jackson_Sheppard
Kaori Shimizu|Kaori_Shimizu
Chie Shinohara|Chie_Shinohara
Terry Skeres|Terry_Skeres
Richard Sky|Richard_Sky
Jack Sloper|Jack_Sloper
Andrew Snowy Owl (Gryffindor)|Andrew_Snowy_Owl_(Gryffindor)
Alicia Spinnet|Alicia_Spinnet
Charlie Stainforth|Charlie_Stainforth
Melanie Stanmore|Melanie_Stanmore
Stewart|Stewart
Tobias Stump|Tobias_Stump
Joshua Sturton|Joshua_Sturton
Yuvraj Suri|Yuvraj_Suri
Jason Swann|Jason_Swann
Sujita Tande|Sujita_Tande
Hardik Tandel|Hardik_Tandel
Rahul Tandel|Rahul_Tandel
Emily Taylor|Emily_Taylor
Dean Thomas|Dean_Thomas
Thorin|Thorin
Toad Toazer|Toad_Toazer
Kenneth Towler|Kenneth_Towler
Trio|Trio
Naoki Tsuchiya|Naoki_Tsuchiya
Emily Tyler|Emily_Tyler
Unidentified 1910s Gryffindor Girl (I)|Unidentified_1910s_Gryffindor_Girl_(I)
Unidentified 1910s Gryffindor Girl (II)|Unidentified_1910s_Gryffindor_Girl_(II)
Unidentified card-playing boy|Unidentified_card-playing_boy
Unidentified friend of McClaggan|Unidentified_friend_of_McClaggan
Unidentified Gryffindor beater|Unidentified_Gryffindor_beater
Unidentified Gryffindor boy (II)|Unidentified_Gryffindor_boy_(II)
Unidentified Gryffindor boy that greets Sir Nicholas (I)|Unidentified_Gryffindor_boy_that_greets_Sir_Nicholas_(I)
Unidentified Gryffindor chaser (I)|Unidentified_Gryffindor_chaser_(I)
Unidentified Gryffindor chaser (II)|Unidentified_Gryffindor_chaser_(II)
Unidentified Gryffindor chaser (III)|Unidentified_Gryffindor_chaser_(III)
Unidentified Gryffindor chaser (IV)|Unidentified_Gryffindor_chaser_(IV)
Unidentified Gryffindor Girl (I)|Unidentified_Gryffindor_Girl_(I)
Unidentified Gryffindor girl (VII)|Unidentified_Gryffindor_girl_(VII)
Unidentified Gryffindor Keeper|Unidentified_Gryffindor_Keeper
Unidentified Gryffindor lady|Unidentified_Gryffindor_lady
Unidentified Gryffindor man (II)|Unidentified_Gryffindor_man_(II)
Unidentified Gryffindor man (III)|Unidentified_Gryffindor_man_(III)
Unidentified Gryffindor man (IV)|Unidentified_Gryffindor_man_(IV)
Unidentified Hogwarts students at the Battle of Hogwarts|Unidentified_Hogwarts_students_at_the_Battle_of_Hogwarts
Unidentified petrified Gryffindor girl|Unidentified_petrified_Gryffindor_girl
Tanner Van Burm|Tanner_Van_Burm
Romilda Vane|Romilda_Vane
Emma Vanity (Gryffindor)|Emma_Vanity_(Gryffindor)
Celestina Warbeck|Celestina_Warbeck
Rose Wax|Rose_Wax
Charles Weasley|Charles_Weasley
Fred Weasley|Fred_Weasley
George Weasley|George_Weasley
Ginevra Weasley|Ginevra_Weasley
Molly Weasley|Molly_Weasley
William Weasley|William_Weasley
Alex Wednesbury|Alex_Wednesbury
Alexander William|Alexander_William
Ruth Winikus|Ruth_Winikus
Nigel Wolpert|Nigel_Wolpert
Oliver Wood|Oliver_Wood
Pauline Yarrow|Pauline_Yarrow
Dinaz Zac|Dinaz_Zac
Giffard Abbott|Giffard_Abbott
Hannah Abbott|Hannah_Abbott
Albert|Albert
Alys|Alys
Tamsin Applebee|Tamsin_Applebee
Arthur (Hufflepuff student)|Arthur_(Hufflepuff_student)
Patrick Bagby|Patrick_Bagby
Martin Beccles|Martin_Beccles
Philip Blagdon|Philip_Blagdon
Susan Bones|Susan_Bones
Wayne Bostock|Wayne_Bostock
Robin Botesdale|Robin_Botesdale
Boy in Study Hall|Boy_in_Study_Hall
Unidentified boy who attended Charm School's father|Unidentified_boy_who_attended_Charm_School%27s_father
Eleanor Branstone|Eleanor_Branstone
Trisha Buttermere|Trisha_Buttermere
Cadwallader|Cadwallader
Diego Caplan|Diego_Caplan
Melvin Catterick|Melvin_Catterick
Owen Cauldwell|Owen_Cauldwell
Poppy Caxton|Poppy_Caxton
Linda Chaddesley|Linda_Chaddesley
Chauncy|Chauncy
Unidentified Choir Member (I)|Unidentified_Choir_Member_(I)
Luke Cholderton|Luke_Cholderton
Martine Copplestone|Martine_Copplestone
Jane Court|Jane_Court
Rohit Das|Rohit_Das
Irene Denholm|Irene_Denholm
Cedric Diggory|Cedric_Diggory
Cedric Diggory's friends|Cedric_Diggory%27s_friends
Thora Dinnet|Thora_Dinnet
Nitin Divekar|Nitin_Divekar
Nicola Dodworth|Nicola_Dodworth
Hufflepuff Duelling Club Captain|Hufflepuff_Duelling_Club_Captain
Craig Dunn|Craig_Dunn
Emily (Hufflepuff)|Emily_(Hufflepuff)
Haruka Endoh|Haruka_Endoh
Annabel Entwhistle|Annabel_Entwhistle
Fat Friar|Fat_Friar
Eustace Fawley|Eustace_Fawley
Grim Fawley|Grim_Fawley
Sullivan Fawley|Sullivan_Fawley
Justin Finch-Fletchley|Justin_Finch-Fletchley
Amelia Fittleworth|Amelia_Fittleworth
Rhonda Fladbury|Rhonda_Fladbury
Herbert Fleet|Herbert_Fleet
Kay Formby|Kay_Formby
Michael Frimley|Michael_Frimley
Trudy Galston|Trudy_Galston
Girl whose quill was taken by Cedric|Girl_whose_quill_was_taken_by_Cedric
Abraham Grimblehawk|Abraham_Grimblehawk
Brendon Halkirk|Brendon_Halkirk
Beatrice Haywood|Beatrice_Haywood
Penny Haywood|Penny_Haywood
Head of Hufflepuff House|Head_of_Hufflepuff_House
Heather|Heather
Gwendoline Hedgeflower|Gwendoline_Hedgeflower
Unidentified Hogwarts Hufflepuff boy who carried a body during the Battle of Hogwarts|Unidentified_Hogwarts_Hufflepuff_boy_who_carried_a_body_during_the_Battle_of_Hogwarts
Wayne Hopkins|Wayne_Hopkins
Unidentified Hufflepuff boy (II)|Unidentified_Hufflepuff_boy_(II)
Hufflepuff boy that blames Harry Potter (I)|Hufflepuff_boy_that_blames_Harry_Potter_(I)
Hufflepuff boy that blames Harry Potter (II)|Hufflepuff_boy_that_blames_Harry_Potter_(II)
Unidentified Hufflepuff boy that greets Sir Nicholas (I)|Unidentified_Hufflepuff_boy_that_greets_Sir_Nicholas_(I)
Unidentified Hufflepuff girl (V)|Unidentified_Hufflepuff_girl_(V)
Unidentified Hufflepuff girl (III)|Unidentified_Hufflepuff_girl_(III)
Unidentified Hufflepuff girl at the Battle of Hogwarts|Unidentified_Hufflepuff_girl_at_the_Battle_of_Hogwarts
Unidentified Hufflepuff girl that greets Sir Nicholas (I)|Unidentified_Hufflepuff_girl_that_greets_Sir_Nicholas_(I)
Hufflepuff Wizard Duelling Champion|Hufflepuff_Wizard_Duelling_Champion
Helga Hufflepuff|Helga_Hufflepuff
Raashid Hussain|Raashid_Hussain
Doris Irlam|Doris_Irlam
James (Hufflepuff Quidditch player)|James_(Hufflepuff_Quidditch_player)
Megan Jones|Megan_Jones
Silvanus Kettleburn|Silvanus_Kettleburn
Matthew Kettletoft|Matthew_Kettletoft
Kevin (2000s Hogwarts student)|Kevin_(2000s_Hogwarts_student)
Hamish Knighton|Hamish_Knighton
Duncan Knottingley|Duncan_Knottingley
Unidentified Hufflepuff lady|Unidentified_Hufflepuff_lady
Leanne|Leanne
Karl Limpley|Karl_Limpley
Chiara Lobosca|Chiara_Lobosca
Artemisia Lufkin|Artemisia_Lufkin
Heidi Macavoy|Heidi_Macavoy
Ernest Macmillan|Ernest_Macmillan
Laura Madley|Laura_Madley
Sisi Makerere|Sisi_Makerere
Unidentified Hufflepuff Seeker|Unidentified_Hufflepuff_Seeker
Unidentified Hufflepuff Substitute Seeker|Unidentified_Hufflepuff_Substitute_Seeker
Male Muggle Studies teacher's student assistant|Male_Muggle_Studies_teacher%27s_student_assistant
Bernard Maltby|Bernard_Maltby
Marilyn|Marilyn
Benjamin McEwen|Benjamin_McEwen
Stuart McKinley|Stuart_McKinley
Michael McManus|Michael_McManus
Dugald McPhail|Dugald_McPhail
Helen Monroe|Helen_Monroe
Gregory Munslow|Gregory_Munslow
Grace Nutley|Grace_Nutley
Harvey O'Brien|Harvey_O%27Brien
Maxine O'Flaherty|Maxine_O%27Flaherty
Hecate Oakham|Hecate_Oakham
Kouta Ohnishi|Kouta_Ohnishi
Madeline Ormskirk|Madeline_Ormskirk
Gillian Ossett|Gillian_Ossett
Anthony Otterburn|Anthony_Otterburn
Manoj Pandit|Manoj_Pandit
Madhumati Parmar|Madhumati_Parmar
Ashish Patel|Ashish_Patel
Bhavana Patel|Bhavana_Patel
Edna Patridge|Edna_Patridge
Sean Peakes|Sean_Peakes
Eldon Pembroke|Eldon_Pembroke
Gareth Pewsey|Gareth_Pewsey
Philip|Philip
Constance Pickering's grandmother|Constance_Pickering%27s_grandmother
Gayle Pocklington|Gayle_Pocklington
Potions Club girl|Potions_Club_girl
Malcolm Preece|Malcolm_Preece
Gladys Prescott|Gladys_Prescott
Sidney Puckeridge|Sidney_Puckeridge
Eglantine Puffett|Eglantine_Puffett
Caroline Purvis|Caroline_Purvis
Anthony Rickett|Anthony_Rickett
Graham Romsey|Graham_Romsey
Lynette Sawley|Lynette_Sawley
Newton Scamander|Newton_Scamander
Theseus Scamander|Theseus_Scamander
Satinder Singh|Satinder_Singh
Zacharias Smith|Zacharias_Smith
Adrian Speke|Adrian_Speke
Pomona Sprout|Pomona_Sprout
Manish Sreenivasan|Manish_Sreenivasan
Stebbins (Potter-era)|Stebbins_(Potter-era)
Grogan Stump|Grogan_Stump
Aki Sugiyama|Aki_Sugiyama
Summerby|Summerby
Summers|Summers
Natsumi Suzuki|Natsumi_Suzuki
Malcolm Swannage|Malcolm_Swannage
Lina Tande|Lina_Tande
Gabriel Tate|Gabriel_Tate
Siobhan Templeton|Siobhan_Templeton
Alistair Thaxted|Alistair_Thaxted
Robyn Thistlethwaite|Robyn_Thistlethwaite
Agatha Thrussington|Agatha_Thrussington
Isabella Tintwistle|Isabella_Tintwistle
Lesley Toddington|Lesley_Toddington
Jessica Tring|Jessica_Tring
Gabriel Truman|Gabriel_Truman
James Tuckett (I)|James_Tuckett_(I)
James Tuckett (II)|James_Tuckett_(II)
Darrel Turner|Darrel_Turner
Unidentified Hufflepuff member of Dumbledore's Army|Unidentified_Hufflepuff_member_of_Dumbledore%27s_Army
Zara Valli|Zara_Valli
Eugene Warmsley|Eugene_Warmsley
Bridget Wenlock|Bridget_Wenlock
Kevin Whitby|Kevin_Whitby
Dora Williams|Dora_Williams
Hengist of Woodcroft|Hengist_of_Woodcroft
Katsuji Yamazaki|Katsuji_Yamazaki
Kousuke Yoshioka|Kousuke_Yoshioka
Rose Zeller|Rose_Zeller
Roland Abberley|Roland_Abberley
Stewart Ackerley|Stewart_Ackerley
Jatin Agarkar|Jatin_Agarkar
Alannis|Alannis
Dennis Aldermaston|Dennis_Aldermaston
Badeea Ali|Badeea_Ali
Pamela Alton|Pamela_Alton
Amanda|Amanda
Yutaka Amano|Yutaka_Amano
Scott Ancrum|Scott_Ancrum
Andrew|Andrew
Becky Arncliffe|Becky_Arncliffe
Millicent Bagnold|Millicent_Bagnold
Arjuna Balaji|Arjuna_Balaji
Yvonne Bampton|Yvonne_Bampton
Marcus Belby|Marcus_Belby
Ethan Bexley|Ethan_Bexley
Trevor Birch|Trevor_Birch
Terry Boot|Terry_Boot
Boy who kept a bezoar in his pocket|Boy_who_kept_a_bezoar_in_his_pocket
Bradley|Bradley
Sage Bragnam|Sage_Bragnam
Mandy Brocklehurst|Mandy_Brocklehurst
Sheila Brooks|Sheila_Brooks
Randolph Burrow|Randolph_Burrow
Eddie Carmichael|Eddie_Carmichael
Chambers|Chambers
Cho Chang|Cho_Chang
Cho Chang's friends|Cho_Chang%27s_friends
Hortense Cooper|Hortense_Cooper
Michael Corner|Michael_Corner
Loretta Cornhill|Loretta_Cornhill
Daisy Corran|Daisy_Corran
Chester Davies|Chester_Davies
Roger Davies|Roger_Davies
Helen Dawlish|Helen_Dawlish
Nanette Desford|Nanette_Desford
Shruti Dev|Shruti_Dev
Ananyo Dhillon|Ananyo_Dhillon
Nathaniel Douglas|Nathaniel_Douglas
Brennan Doyle|Brennan_Doyle
Felicity Eastchurch|Felicity_Eastchurch
Marietta Edgecombe|Marietta_Edgecombe
Andre Egwu|Andre_Egwu
Eliza|Eliza
Harriet Ellesmere|Harriet_Ellesmere
Hilary Erskine|Hilary_Erskine
Margaret Ettington|Margaret_Ettington
Perpetua Fancourt|Perpetua_Fancourt
Fawcett|Fawcett
Marcus Fenwick|Marcus_Fenwick
Patrick Fincher|Patrick_Fincher
Filius Flitwick|Filius_Flitwick
Miranda Flockton|Miranda_Flockton
Basil Fronsac|Basil_Fronsac
Cordelia Gifford|Cordelia_Gifford
Girl with Flowers|Girl_with_Flowers
Maria Glossop|Maria_Glossop
Anthony Goldstein|Anthony_Goldstein
Olivia Green|Olivia_Green
Austin Guthrie|Austin_Guthrie
Noel Harwich|Noel_Harwich
Declan Haworth|Declan_Haworth
Head of Ravenclaw House|Head_of_Ravenclaw_House
Christopher Hemsley|Christopher_Hemsley
Susanna Hesleden|Susanna_Hesleden
Robert Hilliard|Robert_Hilliard
Marcus Hitchin|Marcus_Hitchin
Sanford Humberston|Sanford_Humberston
Jason Huntingdon|Jason_Huntingdon
Shoma Ichikawa|Shoma_Ichikawa
Duncan Inglebee|Duncan_Inglebee
Nola Johnston|Nola_Johnston
Tomoko Kajiwara|Tomoko_Kajiwara
Tulip Karasu|Tulip_Karasu
Andrea Kegworth|Andrea_Kegworth
Sarah Kempston|Sarah_Kempston
Joan Kerridge|Joan_Kerridge
Danny Kershaw|Danny_Kershaw
Ashok Khanna|Ashok_Khanna
Humphrey Kilburn|Humphrey_Kilburn
Noreen Kirkby|Noreen_Kirkby
Biko Kisawahi|Biko_Kisawahi
Unidentified Ravenclaw lady|Unidentified_Ravenclaw_lady
Mark Latchingdon|Mark_Latchingdon
Toby Lennox (Ravenclaw)|Toby_Lennox_(Ravenclaw)
Sue Li|Sue_Li
Gilderoy Lockhart|Gilderoy_Lockhart
Luna Lovegood|Luna_Lovegood
Xenophilius Lovegood|Xenophilius_Lovegood
Roberta Lutterworth|Roberta_Lutterworth
Isobel MacDougal|Isobel_MacDougal
Unidentified Ravenclaw Seeker|Unidentified_Ravenclaw_Seeker
Hugo Mattingley|Hugo_Mattingley
Sterling McCubbin|Sterling_McCubbin
Lorcan McLaird|Lorcan_McLaird
Godfrey Midhurst|Godfrey_Midhurst
Elizabeth Mkapa|Elizabeth_Mkapa
Phillip Montgomery|Phillip_Montgomery
Laverne de Montmorency|Laverne_de_Montmorency
Music classroom monitor|Music_classroom_monitor
Takashi Noda|Takashi_Noda
Banga O'Deluga|Banga_O%27Deluga
Garrick Ollivander|Garrick_Ollivander
Grant Page|Grant_Page
Sherwood Partington|Sherwood_Partington
Padma Patil|Padma_Patil
Swati Pevekar|Swati_Pevekar
Orla Quirke|Orla_Quirke
Quirinus Quirrell|Quirinus_Quirrell
Amina Qureshi|Amina_Qureshi
Asma Rahman|Asma_Rahman
Latisha Randle|Latisha_Randle
Unidentified Ravenclaw boy|Unidentified_Ravenclaw_boy
Unidentified Ravenclaw boy (II)|Unidentified_Ravenclaw_boy_(II)
Unidentified Ravenclaw boy at Hogwarts|Unidentified_Ravenclaw_boy_at_Hogwarts
Ravenclaw Lad|Ravenclaw_Lad
Unidentified Ravenclaw prefect|Unidentified_Ravenclaw_prefect
Unidentified Ravenclaw prefect (II)|Unidentified_Ravenclaw_prefect_(II)
Ravenclaw Wizard Duelling Champion|Ravenclaw_Wizard_Duelling_Champion
Ravenclaw Wizard's Chess champion|Ravenclaw_Wizard%27s_Chess_champion
Helena Ravenclaw|Helena_Ravenclaw
Rowena Ravenclaw|Rowena_Ravenclaw
Raymond|Raymond
Rebecca|Rebecca
Yolanda Reedham|Yolanda_Reedham
Maisy Reynolds|Maisy_Reynolds
Hemani Roshan|Hemani_Roshan
Ophelia Rushden|Ophelia_Rushden
Jason Samuels|Jason_Samuels
Secret student sweetshop manager|Secret_student_sweetshop_manager
Omar Shaw|Omar_Shaw
Alannis Shepley|Alannis_Shepley
Kim Sheringham|Kim_Sheringham
Arman Shettigar|Arman_Shettigar
Justin Steele|Justin_Steele
Hazel Stickney|Hazel_Stickney
Geoffrey Stradbroke|Geoffrey_Stradbroke
Arnold Streeton|Arnold_Streeton
Jeremy Stretton|Jeremy_Stretton
Lewis Thorverton|Lewis_Thorverton
Sybill Trelawney|Sybill_Trelawney
Sachin Tripathy|Sachin_Tripathy
Miyuki Tsuji|Miyuki_Tsuji
Marcus Turner|Marcus_Turner
Lisa Turpin|Lisa_Turpin
Unidentified Ravenclaw black girl during the Battle of Hogwarts|Unidentified_Ravenclaw_black_girl_during_the_Battle_of_Hogwarts
Unidentified Ravenclaw fourth years|Unidentified_Ravenclaw_fourth_years
Unidentified Ravenclaw Girl during the Battle of Hogwarts|Unidentified_Ravenclaw_Girl_during_the_Battle_of_Hogwarts
Unidentified Ravenclaw member of Dumbledore's Army|Unidentified_Ravenclaw_member_of_Dumbledore%27s_Army
Unidentified Ravenclaw student asked to the Yule Ball by a Durmstrang student|Unidentified_Ravenclaw_student_asked_to_the_Yule_Ball_by_a_Durmstrang_student
Unidentified Ravenclaw Substitute Seeker|Unidentified_Ravenclaw_Substitute_Seeker
Uric the Oddball|Uric_the_Oddball
Gerald Vickers|Gerald_Vickers
Myrtle Warren|Myrtle_Warren
Ignatia Wildsmith|Ignatia_Wildsmith
Gerard Willerby|Gerard_Willerby
Talbott Winger|Talbott_Winger
Aron Woodbridge|Aron_Woodbridge
Nigel Wroxton|Nigel_Wroxton
Mizuho Yoshii|Mizuho_Yoshii
Zoe Accrington|Zoe_Accrington
Uchi Akimbo|Uchi_Akimbo
Duncan Ashe|Duncan_Ashe
Avery I|Avery_I
Avery II|Avery_II
Malcolm Baddock|Malcolm_Baddock
Tabitha Bainbridge|Tabitha_Bainbridge
Sadie Baldock|Sadie_Baldock
Tristram Bassenthwaite|Tristram_Bassenthwaite
Darius Berrow|Darius_Berrow
Bespectacled Slytherin girl|Bespectacled_Slytherin_girl
Yatin Bhagat|Yatin_Bhagat
Kinjal Bhatia|Kinjal_Bhatia
Vicky Bishopper|Vicky_Bishopper
Callidora Black|Callidora_Black
Cassiopeia Black|Cassiopeia_Black
Charis Black|Charis_Black
Cygnus Black III|Cygnus_Black_III
Dorea Black|Dorea_Black
Lucretia Black|Lucretia_Black
Orion Black|Orion_Black
Phineas Nigellus Black|Phineas_Nigellus_Black
Regulus Black|Regulus_Black
Walburga Black|Walburga_Black
Kevin Bletchley|Kevin_Bletchley
Miles Bletchley|Miles_Bletchley
Lucian Bole|Lucian_Bole
Craig Bowker Junior|Craig_Bowker_Junior
Unidentified boy who attended Charm School|Unidentified_boy_who_attended_Charm_School
Boy who failed Avifors Spell's cousin|Boy_who_failed_Avifors_Spell%27s_cousin
Boy who owned a magic hamster|Boy_who_owned_a_magic_hamster
Cameron Boyle|Cameron_Boyle
Bridget|Bridget
Nerissa Brody|Nerissa_Brody
Millicent Bulstrode|Millicent_Bulstrode
Elizabeth Burke|Elizabeth_Burke
Alecto Carrow|Alecto_Carrow
Amycus Carrow|Amycus_Carrow
Flora Carrow|Flora_Carrow
Hestia Carrow|Hestia_Carrow
Diane Carter|Diane_Carter
Cassandra (Hogwarts student)|Cassandra_(Hogwarts_student)
Fergus Cowley|Fergus_Cowley
Stuart Craggy|Stuart_Craggy
Irving Cram (II)|Irving_Cram_(II)
Winky Crockett (Slytherin)|Winky_Crockett_(Slytherin)
Sebastian Daley|Sebastian_Daley
Dan Darker|Dan_Darker
Tracey Davis|Tracey_Davis
Simon Dedworth (II)|Simon_Dedworth_(II)
Peregrine Derrick|Peregrine_Derrick
Draco Malfoy's gang|Draco_Malfoy%27s_gang
Slytherin Duelling Club Captain|Slytherin_Duelling_Club_Captain
Bowen Duffield|Bowen_Duffield
Dungeon Corridor Slytherin prefect (I)|Dungeon_Corridor_Slytherin_prefect_(I)
Dungeon Corridor Slytherin prefect (II)|Dungeon_Corridor_Slytherin_prefect_(II)
Curtis Evercreech|Curtis_Evercreech
Gemma Farley|Gemma_Farley
Penelope Fawley|Penelope_Fawley
Sixth-Year Inquisitorial Squad Member|Sixth-Year_Inquisitorial_Squad_Member
Marcus Flint|Marcus_Flint
Colby Frey|Colby_Frey
Fisher Frey|Fisher_Frey
Amy Frome|Amy_Frome
Gang of Slytherins|Gang_of_Slytherins
Corvinus Gaunt|Corvinus_Gaunt
Gormlaith Gaunt|Gormlaith_Gaunt
Damon Gosforth|Damon_Gosforth
Mathilda Greenford|Mathilda_Greenford
Daphne Greengrass|Daphne_Greengrass
Amrish Gupta|Amrish_Gupta
Yurika Haneda|Yurika_Haneda
Niles Hanley|Niles_Hanley
Harper|Harper
Maynard Hatton|Maynard_Hatton
Head of Slytherin House|Head_of_Slytherin_House
Terence Higgs|Terence_Higgs
Robin Higgy|Robin_Higgy
Manami Ichijoh|Manami_Ichijoh
Malcolm Ilminster|Malcolm_Ilminster
Jody Jacknife|Jody_Jacknife
Trupti Kadam|Trupti_Kadam
Sourav Kartik|Sourav_Kartik
Zubeida Khan|Zubeida_Khan
Jo King (Slytherin)|Jo_King_(Slytherin)
Unidentified Slytherin knight|Unidentified_Slytherin_knight
Kris Kolumbiko|Kris_Kolumbiko
Hirohisa Kubo|Hirohisa_Kubo
Jess Lafington|Jess_Lafington
Neil Lament|Neil_Lament
Steve Laughalot|Steve_Laughalot
Maxwell Lazenby|Maxwell_Lazenby
Holden Ledbury|Holden_Ledbury
Barnaby Lee |Barnaby_Lee_
Lestrange|Lestrange
Leta Lestrange|Leta_Lestrange
Rodolphus Lestrange|Rodolphus_Lestrange
Gabriel Lithgow|Gabriel_Lithgow
Xander Lofthouse|Xander_Lofthouse
Russell Lucky|Russell_Lucky
Scarlett Lympsham|Scarlett_Lympsham
Charles Machin|Charles_Machin
Mafalda|Mafalda
David Makehay|David_Makehay
Abraxas Malfoy|Abraxas_Malfoy
Draco Malfoy|Draco_Malfoy
Lucius Malfoy|Lucius_Malfoy
Narcissa Malfoy|Narcissa_Malfoy
Scorpius Malfoy|Scorpius_Malfoy
Thomas McGruder|Thomas_McGruder
Gertrude Meads|Gertrude_Meads
Sylvia Melville|Sylvia_Melville
Merlin|Merlin
Merula Snyde's gang|Merula_Snyde%27s_gang
Glynis Mexborough|Glynis_Mexborough
Byron Miller|Byron_Miller
Titus Mitcham|Titus_Mitcham
Agnes Monkleigh|Agnes_Monkleigh
Graham Montague|Graham_Montague
Selina Moore|Selina_Moore
Timothy Morcott|Timothy_Morcott
Daryl Morden|Daryl_Morden
Shawn Morris|Shawn_Morris
Mulciber II|Mulciber_II
Ismelda Murk|Ismelda_Murk
Adelaide Murton|Adelaide_Murton
Irfan Mustaq|Irfan_Mustaq
Tracey Nettlebed|Tracey_Nettlebed
Garrick Newbourne|Garrick_Newbourne
Nigel's nephew|Nigel%27s_nephew
Theodore Nott|Theodore_Nott
Nerys Orpington|Nerys_Orpington
Mark Overcliff|Mark_Overcliff
Pansy Parkinson's gang|Pansy_Parkinson%27s_gang
Ona Parangyo|Ona_Parangyo
Pansy Parkinson|Pansy_Parkinson
Mildred Peebles|Mildred_Peebles
Ursula Penkridge|Ursula_Penkridge
Horatio Pershore|Horatio_Pershore
Peter|Peter
Ronald Phipps|Ronald_Phipps
Pike|Pike
Albus Potter|Albus_Potter
Graham Pritchard|Graham_Pritchard
Adrian Pucey|Adrian_Pucey
Abigail Pugh|Abigail_Pugh
Gordon Pummell (II)|Gordon_Pummell_(II)
Bastien Queensbury|Bastien_Queensbury
Hayley Quentin|Hayley_Quentin
Rachel|Rachel
Katie Rayknolls|Katie_Rayknolls
Viola Richmond|Viola_Richmond
Michael Robinson|Michael_Robinson
Evan Rosier|Evan_Rosier
Felix Rosier|Felix_Rosier
Muriel Rothley|Muriel_Rothley
Hortense Rowland|Hortense_Rowland
Megan Rowstock|Megan_Rowstock
Roy|Roy
Scabior|Scabior
Gideon Scalby|Gideon_Scalby
Poonima Shah|Poonima_Shah
Olivia Shardlow|Olivia_Shardlow
Bhupen Shastri|Bhupen_Shastri
Archana Shetty|Archana_Shetty
Reiko Shibazaki|Reiko_Shibazaki
Horace Slughorn|Horace_Slughorn
Slytherin boy who drank a botched potion|Slytherin_boy_who_drank_a_botched_potion
Slytherin student that blames Harry Potter (I)|Slytherin_student_that_blames_Harry_Potter_(I)
Slytherin student that blames Harry Potter (II)|Slytherin_student_that_blames_Harry_Potter_(II)
Slytherin Wizard Duelling Champion|Slytherin_Wizard_Duelling_Champion
Slytherin Wizard's Chess champion|Slytherin_Wizard%27s_Chess_champion
Salazar Slytherin|Salazar_Slytherin
Andrew Snowy Owl (Slytherin)|Andrew_Snowy_Owl_(Slytherin)
Merula Snyde|Merula_Snyde
Merula Snyde's father|Merula_Snyde%27s_father
Merula Snyde's mother|Merula_Snyde%27s_mother
Mark Sommertime|Mark_Sommertime
Grant Sparkford|Grant_Sparkford
Cole Spencer|Cole_Spencer
Norman Stacey|Norman_Stacey
Imogen Stretton|Imogen_Stretton
Junpei Suruga|Junpei_Suruga
Alex Sykes (II)|Alex_Sykes_(II)
Atsushi Takagi|Atsushi_Takagi
Lucinda Talkalot|Lucinda_Talkalot
Vikram Thakur|Vikram_Thakur
Heather Thatcham|Heather_Thatcham
Third Floor Corridor Slytherin prefect|Third_Floor_Corridor_Slytherin_prefect
Third Floor Slytherin Prefect|Third_Floor_Slytherin_Prefect
Tom Riddle's gang|Tom_Riddle%27s_gang
Liz Tuttle|Liz_Tuttle
Dolores Umbridge|Dolores_Umbridge
Unidentified blonde Slytherin girl|Unidentified_blonde_Slytherin_girl
Unidentified Slytherin Beater|Unidentified_Slytherin_Beater
Unidentified Slytherin Beater (II)|Unidentified_Slytherin_Beater_(II)
Unidentified Slytherin boy (I)|Unidentified_Slytherin_boy_(I)
Unidentified Slytherin boy in the Battle of Hogwarts|Unidentified_Slytherin_boy_in_the_Battle_of_Hogwarts
Unidentified Slytherin girl (I)|Unidentified_Slytherin_girl_(I)
Unidentified Slytherin girl (IV)|Unidentified_Slytherin_girl_(IV)
Unidentified Slytherin Keeper|Unidentified_Slytherin_Keeper
Urquhart|Urquhart
Vaisey|Vaisey
Emma Vanity (Slytherin)|Emma_Vanity_(Slytherin)
Cassius Warrington|Cassius_Warrington
Spencer Whiddon|Spencer_Whiddon
Phylis Whitehead|Phylis_Whitehead
Wilkes|Wilkes
Ella Wilkins|Ella_Wilkins
Rufus Winickus|Rufus_Winickus
Blaise Zabini|Blaise_Zabini
Adrian|Adrian
Orion Amari|Orion_Amari
Bertram Aubrey|Bertram_Aubrey
Bean|Bean
Damocles Belby|Damocles_Belby
Albert Bellchant|Albert_Bellchant
Billingsley|Billingsley
Bilton Bilmes|Bilton_Bilmes
Bletchley (musician)|Bletchley_(musician)
Melinda Bobbin|Melinda_Bobbin
David Boorman II|David_Boorman_II
D. L. Boot|D._L._Boot
Boy who failed Avifors Spell|Boy_who_failed_Avifors_Spell
Boy who played Sir Luckless|Boy_who_played_Sir_Luckless
Felix Brunt (I)|Felix_Brunt_(I)
Felix Brunt (II)|Felix_Brunt_(II)
Flora Buchanan|Flora_Buchanan
Hamish Buchanan|Hamish_Buchanan
Zygmunt Budge|Zygmunt_Budge
K. Bundy|K._Bundy
Bunty|Bunty
Timothy Butler|Timothy_Butler
B. C.|B._C.
S. Capper|S._Capper
Luca Caruso (wizard)|Luca_Caruso_(wizard)
Cedric|Cedric
Stephen Cornfoot|Stephen_Cornfoot
Irving Cram (I)|Irving_Cram_(I)
Dirk Cresswell|Dirk_Cresswell
Barnabas Cuffe|Barnabas_Cuffe
Davis|Davis
John Dawlish|John_Dawlish
Simon Dedworth (I)|Simon_Dedworth_(I)
Derek (turtle talker)|Derek_(turtle_talker)
Harold Dingle|Harold_Dingle
Armando Dippet|Armando_Dippet
Distractible Douglas|Distractible_Douglas
Elphias Doge|Elphias_Doge
J. Dorny|J._Dorny
Kirley Duke|Kirley_Duke
Elora Dunn|Elora_Dunn
B. Dunstan|B._Dunstan
Kevin Entwhistle|Kevin_Entwhistle
Erika Rath's friend I|Erika_Rath%27s_friend_I
Erika Rath's friend II|Erika_Rath%27s_friend_II
Dahlia F.|Dahlia_F.
Face Paint Kid|Face_Paint_Kid
Mundungus Fletcher|Mundungus_Fletcher
Florence|Florence
Florence's boyfriend|Florence%27s_boyfriend
Fiesella Foss|Fiesella_Foss
Cornelius Fudge|Cornelius_Fudge
Ross Gibberd (I)|Ross_Gibberd_(I)
Miranda Goshawk|Miranda_Goshawk
Mathilda Grimblehawk|Mathilda_Grimblehawk
Davey Gudgeon|Davey_Gudgeon
Karl H.|Karl_H.
Hogwarts Express conductor|Hogwarts_Express_conductor
Hogwarts potions champion|Hogwarts_potions_champion
Unidentified Hogwarts student interested in earth magic|Unidentified_Hogwarts_student_interested_in_earth_magic
Hogwarts student that bets on Fleur Delacour|Hogwarts_student_that_bets_on_Fleur_Delacour
Hogwarts student that blames Harry Potter|Hogwarts_student_that_blames_Harry_Potter
Olive Hornby|Olive_Hornby
Jacob (Hogwarts student)|Jacob_(Hogwarts_student)
Jacob's sibling|Jacob%27s_sibling
James Potter II's friends|James_Potter_II%27s_friends
Jarrett|Jarrett
Karl Jenkins|Karl_Jenkins
Gwenog Jones|Gwenog_Jones
Bertha Jorkins|Bertha_Jorkins
Rowan Khanna|Rowan_Khanna
Cecil Lee|Cecil_Lee
Augusta Longbottom|Augusta_Longbottom
Louise|Louise
Louise's admirer|Louise%27s_admirer
Luisa|Luisa
Lyall Lupin|Lyall_Lupin
Mary Macdonald|Mary_Macdonald
Morag MacDougal|Morag_MacDougal
Dominic Maestro|Dominic_Maestro
Paul Males|Paul_Males
Astoria Malfoy|Astoria_Malfoy
Roger Malone|Roger_Malone
Mary I|Mary_I
Mathilda Grimblehawk's partner|Mathilda_Grimblehawk%27s_partner
Murphy McNully|Murphy_McNully
Sean Miller|Sean_Miller
Montgomery sisters|Montgomery_sisters
Lily Moon|Lily_Moon
Morag|Morag
Angelus Moriattis|Angelus_Moriattis
Maurice Netto|Maurice_Netto
Nott|Nott
Daniel Page|Daniel_Page
Ethan Parkin|Ethan_Parkin
Skye Parkin|Skye_Parkin
Sally-Anne Perks|Sally-Anne_Perks
Constance Pickering|Constance_Pickering
J. E. Prewitt|J._E._Prewitt
Eileen Prince|Eileen_Prince
Gordon Pummell (I)|Gordon_Pummell_(I)
Erika Rath|Erika_Rath
Ivan Renshaw (I)|Ivan_Renshaw_(I)
Ivan Renshaw (II)|Ivan_Renshaw_(II)
Oliver Rivers|Oliver_Rivers
Roger Davies's girlfriend|Roger_Davies%27s_girlfriend
Sophie Roper|Sophie_Roper
Ross Gibberd (II)|Ross_Gibberd_(II)
Isobel Ross|Isobel_Ross
Marina Sanchez|Marina_Sanchez
Kingsley Shacklebolt|Kingsley_Shacklebolt
Shady Character|Shady_Character
Wendy Slinkhard|Wendy_Slinkhard
Sally Smith|Sally_Smith
Squibbert|Squibbert
Stebbins (Marauder-era)|Stebbins_(Marauder-era)
Patricia Stimpson|Patricia_Stimpson
Bethany Swordbane|Bethany_Swordbane
Alex Sykes (I)|Alex_Sykes_(I)
Tyra Teegarden|Tyra_Teegarden
Alice Tolipan (witch)|Alice_Tolipan_(witch)
Lottie Turner|Lottie_Turner
Unidentified 19th-century Hogwarts student|Unidentified_19th-century_Hogwarts_student
Unidentified 2000s Hogwarts student|Unidentified_2000s_Hogwarts_student
Unidentified Beater|Unidentified_Beater
Unidentified boy during the 1996 Quidditch match (I)|Unidentified_boy_during_the_1996_Quidditch_match_(I)
Unidentified boy in a corridor|Unidentified_boy_in_a_corridor
Unidentified boy in the Great Hall (I)|Unidentified_boy_in_the_Great_Hall_(I)
Unidentified boy in the Great Hall (II)|Unidentified_boy_in_the_Great_Hall_(II)
Unidentified boy in the Great Hall (III)|Unidentified_boy_in_the_Great_Hall_(III)
Unidentified Chaser|Unidentified_Chaser
Unidentified Choir Member (II)|Unidentified_Choir_Member_(II)
Unidentified Clumsy Hogwarts Violist|Unidentified_Clumsy_Hogwarts_Violist
Unidentified female Hogwarts student who helped Unidentified Female Hogwarts teacher (XII)|Unidentified_female_Hogwarts_student_who_helped_Unidentified_Female_Hogwarts_teacher_(XII)
Unidentified fifth year girl|Unidentified_fifth_year_girl
Unidentified first year boy|Unidentified_first_year_boy
Unidentified fourth year Chaser|Unidentified_fourth_year_Chaser
Unidentified girl during the Battle of Hogwarts|Unidentified_girl_during_the_Battle_of_Hogwarts
Unidentified girl in the Great Hall (I)|Unidentified_girl_in_the_Great_Hall_(I)
Unidentified Keeper|Unidentified_Keeper
Unidentified Minister of Magical Transportation|Unidentified_Minister_of_Magical_Transportation
Unidentified petrified boy|Unidentified_petrified_boy
Unidentified petrified girl|Unidentified_petrified_girl
Unidentified petrified girl (II)|Unidentified_petrified_girl_(II)
Unidentified petrified student|Unidentified_petrified_student
Unidentified Potions student|Unidentified_Potions_student
Unidentified Seeker|Unidentified_Seeker
Unidentified third year boy|Unidentified_third_year_boy
Thomas Vace|Thomas_Vace
Myron Wagtail|Myron_Wagtail
Walker (Hogwarts student)|Walker_(Hogwarts_student)
Ivy Warrington|Ivy_Warrington
Panju Weasley|Panju_Weasley
Victoire Weasley|Victoire_Weasley
Simon Wilkinson|Simon_Wilkinson
William (Hogwarts student)|William_(Hogwarts_student)
Winston's niece|Winston%27s_niece
Eldred Worple|Eldred_Worple
Alastair|Alastair
Aragog|Aragog
Chavelle Arbelo Cartaya|Chavelle_Arbelo_Cartaya
Babayaga|Babayaga
Bogrod|Bogrod
Clever goblin|Clever_goblin
Fawkes|Fawkes
Forest Vault Acromantula|Forest_Vault_Acromantula
Inigo Fuente Marrero|Inigo_Fuente_Marrero
Gnarlak|Gnarlak
Goblin jazz singer|Goblin_jazz_singer
Griphook|Griphook
Lee Jordan's tarantula|Lee_Jordan%27s_tarantula
Ludovic Bagman's goblin creditors|Ludovic_Bagman%27s_goblin_creditors
Magic goblin|Magic_goblin
Olympe Maxime|Olympe_Maxime
Merwyn the Malicious|Merwyn_the_Malicious
Mosag|Mosag
Peeves|Peeves
Pickett|Pickett
Portrait of a goblin|Portrait_of_a_goblin
Red|Red
Ricbert|Ricbert
Ripper|Ripper
Sickleworth|Sickleworth
Snaglok|Snaglok
Sparky|Sparky
Tall goblin|Tall_goblin
Trevor|Trevor
Unidentified female Common Welsh Green|Unidentified_female_Common_Welsh_Green
Unidentified goblin associate of Oswald Beamish|Unidentified_goblin_associate_of_Oswald_Beamish
Unidentified Goblin at Gringotts (VIII)|Unidentified_Goblin_at_Gringotts_(VIII)
Unidentified Goblin at Gringotts in 1998 (I)|Unidentified_Goblin_at_Gringotts_in_1998_(I)
Unidentified Goblin at Gringotts in 1998 (II)|Unidentified_Goblin_at_Gringotts_in_1998_(II)
Unidentified Goblin at Gringotts in 1998 (III)|Unidentified_Goblin_at_Gringotts_in_1998_(III)
Unidentified Goblin at Gringotts in 1998 (IV)|Unidentified_Goblin_at_Gringotts_in_1998_(IV)
Unidentified Goblin at Gringotts in 1998 (V)|Unidentified_Goblin_at_Gringotts_in_1998_(V)
Unidentified Goblin at Gringotts in 1998 (VI)|Unidentified_Goblin_at_Gringotts_in_1998_(VI)
Unidentified goblin stockbroker|Unidentified_goblin_stockbroker
Arnold Vogler|Arnold_Vogler
Ludovic Bagman|Ludovic_Bagman
Chastity Barebone|Chastity_Barebone
Mary Lou Barebone|Mary_Lou_Barebone
Modesty Barebone|Modesty_Barebone
Musidora Barkwith|Musidora_Barkwith
Astor Bellchant|Astor_Bellchant
Balfour Blane|Balfour_Blane
Kursten Blijk|Kursten_Blijk
Boil-ridden house-elf|Boil-ridden_house-elf
Broom Shop shopkeeper|Broom_Shop_shopkeeper
Greta Catchlove|Greta_Catchlove
Mary Cattermole|Mary_Cattermole
Jacturus Cloke III|Jacturus_Cloke_III
Magenta Comstock|Magenta_Comstock
Gideon Crumb|Gideon_Crumb
Lorcan d'Eath|Lorcan_d%27Eath
Fleur Delacour|Fleur_Delacour
Daisy Dodderidge|Daisy_Dodderidge
Aberforth Dumbledore|Aberforth_Dumbledore
Dudley Dursley|Dudley_Dursley
Firenze|Firenze
Flavius Belby|Flavius_Belby
Keaton Flitney|Keaton_Flitney
Fulbert the Fearful|Fulbert_the_Fearful
Gigantic serpent|Gigantic_serpent
Hans|Hans
Peter Hansen|Peter_Hansen
Bethany Harrison|Bethany_Harrison
Hengist of Upper Barnton|Hengist_of_Upper_Barnton
Phillipus von Hohenheim|Phillipus_von_Hohenheim
Igor Karkaroff|Igor_Karkaroff
Elladora Ketteridge|Elladora_Ketteridge
Asgeir Knutsen|Asgeir_Knutsen
Maeve|Maeve
Mathilde Mallard|Mathilde_Mallard
Tarquin McTavish|Tarquin_McTavish
Mildred|Mildred
Mopsus (antiquity)|Mopsus_(antiquity)
Morgan le Fay|Morgan_le_Fay
Burdock Muldoon|Burdock_Muldoon
Mulpepper|Mulpepper
Idris Oakby|Idris_Oakby
Dunbar Oglethorpe|Dunbar_Oglethorpe
Old Mother Hubbard|Old_Mother_Hubbard
Chauncey Oldridge|Chauncey_Oldridge
Patrick|Patrick
Glanmore Peakes|Glanmore_Peakes
Justus Pilliwickle|Justus_Pilliwickle
Roderick Plumpton|Roderick_Plumpton
Mirabella Plunkett|Mirabella_Plunkett
Gulliver Pokeby|Gulliver_Pokeby
Potage|Potage
Percival Pratt|Percival_Pratt
Paloma Proudfoot|Paloma_Proudfoot
Hambledon Quince|Hambledon_Quince
Mnemone Radford|Mnemone_Radford
Percival Shacklehorn|Percival_Shacklehorn
Edessa Skandenberg|Edessa_Skandenberg
St Mungo's Welcome Witch|St_Mungo%27s_Welcome_Witch
Erica Stainwright|Erica_Stainwright
Blenheim Stalk|Blenheim_Stalk
Edgar Stroulger|Edgar_Stroulger
Sugarplum|Sugarplum
Havelock Sweeting|Havelock_Sweeting
Jocunda Sykes|Jocunda_Sykes
Robertus Tallis|Robertus_Tallis
Tilly Toke|Tilly_Toke
Alberta Toothill|Alberta_Toothill
Tilden Toots|Tilden_Toots
Norvel Twonk|Norvel_Twonk
Ug the Unreliable|Ug_the_Unreliable
Unidentified Muggle man|Unidentified_Muggle_man
Unidentified newspaper vendor|Unidentified_newspaper_vendor
Viking Girl|Viking_Girl
Pyotr Vulchanov|Pyotr_Vulchanov
Joscelind Wadcock|Joscelind_Wadcock
Fabius Watkins|Fabius_Watkins
Konrad Weiss|Konrad_Weiss
Devlin Whitehorn|Devlin_Whitehorn
Winifred Whittle|Winifred_Whittle
Stoddard Withers|Stoddard_Withers
Bowman Wright|Bowman_Wright
Omar Abasi|Omar_Abasi
Alguff the Awful|Alguff_the_Awful
Alanza Alves|Alanza_Alves
Michael Babatola|Michael_Babatola
Gwendoline Babcocke|Gwendoline_Babcocke
Humphrey Balsamo|Humphrey_Balsamo
Credence Barebone|Credence_Barebone
Barnabas the Barmy|Barnabas_the_Barmy
Mungo Bonham|Mungo_Bonham
Chadwick Boot|Chadwick_Boot
Webster Boot|Webster_Boot
Borf|Borf
Bran the Bloodthirsty|Bran_the_Bloodthirsty
Indira Choudry|Indira_Choudry
Circe|Circe
Antonia Creaseworthy|Antonia_Creaseworthy
Myra Curio|Myra_Curio
Cyclops|Cyclops
Dougal|Dougal
Troy Duvall|Troy_Duvall
Eargit the Ugly|Eargit_the_Ugly
Wilfred Elphick|Wilfred_Elphick
Ethelred the Ever-Ready|Ethelred_the_Ever-Ready
Gianni Fedele|Gianni_Fedele
Fluffy|Fluffy
Ulick Gamp|Ulick_Gamp
Carmen Garcia|Carmen_Garcia
Marvolo Gaunt|Marvolo_Gaunt
George von Rheticus|George_von_Rheticus
Porpentina Goldstein|Porpentina_Goldstein
Merton Graves|Merton_Graves
Grawp|Grawp
Robert Green|Robert_Green
Gareth Greengrass|Gareth_Greengrass
Gringott|Gringott
Avery Hawksworth|Avery_Hawksworth
Ernest Hawkworth|Ernest_Hawkworth
Healer (Diagon Alley)|Healer_(Diagon_Alley)
Daisy Hookum|Daisy_Hookum
Gordon Horton|Gordon_Horton
Igor Karkaroff's Yule Ball partner|Igor_Karkaroff%27s_Yule_Ball_partner
Karkaroff's Aide|Karkaroff%27s_Aide
Koldovstoretz potions champion|Koldovstoretz_potions_champion
Jacob Kowalski|Jacob_Kowalski
Hildegarde Lafarge|Hildegarde_Lafarge
Fifi LaFolle|Fifi_LaFolle
Laurentia Fletwock|Laurentia_Fletwock
Ana de Lebron|Ana_de_Lebron
Jacqueline Lejeune|Jacqueline_Lejeune
Eduardo Lima Filho|Eduardo_Lima_Filho
Tina Lundstrom|Tina_Lundstrom
Magnus|Magnus
Manager of Gambol and Japes Wizarding Joke Shop|Manager_of_Gambol_and_Japes_Wizarding_Joke_Shop
Josephine Marat|Josephine_Marat
Dorcas Meadowes|Dorcas_Meadowes
Kylie Meadows|Kylie_Meadows
Maria Monteith|Maria_Monteith
Morholt|Morholt
Debbie Muntz|Debbie_Muntz
Gondoline Oliphant|Gondoline_Oliphant
Blythe Parkin|Blythe_Parkin
Seraphina Picquery|Seraphina_Picquery
Vasco Santini|Vasco_Santini
Noriyuki Sato|Noriyuki_Sato
Ninon Saucet|Ninon_Saucet
Lydia Scarlett|Lydia_Scarlett
Derwent Shimpling|Derwent_Shimpling
Leticia Somnolens|Leticia_Somnolens
Hesper Starkey|Hesper_Starkey
Martha Steward II|Martha_Steward_II
Felix Summerbee|Felix_Summerbee
Laura Thorn|Laura_Thorn
Timothy the Timid|Timothy_the_Timid
Kurt Todt|Kurt_Todt
Tofty|Tofty
Torvus|Torvus
Villanelle|Villanelle
Edric Vosper|Edric_Vosper
Waitress at Treats|Waitress_at_Treats
Shizuka Watanabe|Shizuka_Watanabe
Kelly Whakkaarangapawarau|Kelly_Whakkaarangapawarau
William (Pukwudgie)|William_(Pukwudgie)
Winky|Winky
Wizard in white robes|Wizard_in_white_robes
Yaxley (1920s)|Yaxley_(1920s)
Cornelius Agrippa|Cornelius_Agrippa
Olaf Andersen|Olaf_Andersen
Beatrix Bloxam|Beatrix_Bloxam
Igor Brand|Igor_Brand
Cassius Bell|Cassius_Bell
Elfrida Clagg|Elfrida_Clagg
Cliodna|Cliodna
Cobb & Webb's shopkeeper|Cobb_%26_Webb%27s_shopkeeper
Vasily Dimitrov|Vasily_Dimitrov
Dobby|Dobby
Sara Farnham|Sara_Farnham
Bilius Finbok|Bilius_Finbok
Dymphna Furmage|Dymphna_Furmage
Queenie Goldstein|Queenie_Goldstein
Gunhilda de Gorsemoor|Gunhilda_de_Gorsemoor
Malodora Grymm|Malodora_Grymm
Millie Gudabi|Millie_Gudabi
Don Harrison|Don_Harrison
Jarleth Hobart|Jarleth_Hobart
Clara Ivanova|Clara_Ivanova
Montague Knightley|Montague_Knightley
Alain Lacroix|Alain_Lacroix
Cerberus Langarm|Cerberus_Langarm
Barnaby Lee|Barnaby_Lee
Alexei Levski|Alexei_Levski
Beaumont Marjoribanks|Beaumont_Marjoribanks
Miraphora Mina (Ministry employee)|Miraphora_Mina_(Ministry_employee)
Cordelia Misericordia|Cordelia_Misericordia
Carlotta Pinkstone|Carlotta_Pinkstone
Potters' cat|Potters%27_cat
Gethsemane Prickle|Gethsemane_Prickle
Raymond's kitten|Raymond%27s_kitten
Harvey Ridgebit|Harvey_Ridgebit
Rosmerta|Rosmerta
Megan Scott|Megan_Scott
Gaspard Shingleton|Gaspard_Shingleton
Skower|Skower
Sacharissa Tugwood|Sacharissa_Tugwood
Ivan Volkov|Ivan_Volkov
Dorcas Wellbeloved|Dorcas_Wellbeloved
Wendelin the Weird|Wendelin_the_Weird
Oswald Beamish|Oswald_Beamish
Philbert Chivers|Philbert_Chivers
Cordelia Vexmoor|Cordelia_Vexmoor
Silas Crump|Silas_Crump
Argus Filch|Argus_Filch
Jeremiah Garnet|Jeremiah_Garnet
Landlord of the Siren's Rest|Landlord_of_the_Siren%27s_Rest
Pandora Lovegood|Pandora_Lovegood
Unidentified ghost horse (I)|Unidentified_ghost_horse_(I)
Catriona McCormack|Catriona_McCormack
Yardley Platt|Yardley_Platt
Giant rat (creature)|Giant_rat_(creature)
Brodwin|Brodwin
Buckbeak|Buckbeak
Buried Vault Hungarian Horntail|Buried_Vault_Hungarian_Horntail
Crookshanks|Crookshanks
Dennis (toad)|Dennis_(toad)
Vlad Drakul|Vlad_Drakul
Ghoul in the Muggle Studies Classroom|Ghoul_in_the_Muggle_Studies_Classroom
Goliath|Goliath
Hedwig|Hedwig
Herpo the Foul|Herpo_the_Foul
Hieronymus|Hieronymus
Rolanda Hooch|Rolanda_Hooch
Mrs Norris|Mrs_Norris
Murcus|Murcus
Carmilla Sanguina|Carmilla_Sanguina
Rufus Scrimgeour|Rufus_Scrimgeour
Serpent of Slytherin|Serpent_of_Slytherin
Silas Crump's cat|Silas_Crump%27s_cat
Unidentified Chinese Fireball's offspring|Unidentified_Chinese_Fireball%27s_offspring
Unidentified female Chinese Fireball|Unidentified_female_Chinese_Fireball
Unidentified female Hungarian Horntail|Unidentified_female_Hungarian_Horntail
Unidentified Merman (Black Lake)|Unidentified_Merman_(Black_Lake)
Vaults Guardian|Vaults_Guardian
Falco Aesalon|Falco_Aesalon
Animagus|Animagus
International Symposium of Animagi|International_Symposium_of_Animagi
Morrigan|Morrigan
Unidentified registered Animagus|Unidentified_registered_Animagus
Adrian Tutley|Adrian_Tutley
Uagadou School Team|Uagadou_School_Team
Unidentified 1920s Animagus|Unidentified_1920s_Animagus
Unidentified five Animagi|Unidentified_five_Animagi
Talbott Winger's mother|Talbott_Winger%27s_mother
Sorting Hat|Sorting_Hat
Maledictus|Maledictus
Nagini|Nagini
Metamorphmagus|Metamorphmagus
Obscurial|Obscurial
Unidentified Sudanese Obscurial|Unidentified_Sudanese_Obscurial
Maxwell Barnett|Maxwell_Barnett
Boa constrictor at the Zoo|Boa_constrictor_at_the_Zoo
Delphini|Delphini
Morfin Gaunt|Morfin_Gaunt
Parseltongue|Parseltongue
Calchas|Calchas
Tycho Dodonus|Tycho_Dodonus
Unidentified female Seer|Unidentified_female_Seer
Johan Hoffman|Johan_Hoffman
Inigo Imago|Inigo_Imago
Unidentified male Seer|Unidentified_male_Seer
Mopsus (Potter-era)|Mopsus_(Potter-era)
Naming Seer|Naming_Seer
Wandkeeper|Wandkeeper
Seer|Seer
Susie Sooth|Susie_Sooth
Cassandra Trelawney|Cassandra_Trelawney
Liz Tuttle's mother|Liz_Tuttle%27s_mother
Unidentified Canadian Seer|Unidentified_Canadian_Seer
Cassandra Vablatsky|Cassandra_Vablatsky
Ancient African sorcerer|Ancient_African_sorcerer
Blagdon Blay|Blagdon_Blay
Delfina Crimp|Delfina_Crimp
Daisy Pennifold|Daisy_Pennifold
Basil Horton|Basil_Horton
Helixa Hyslop|Helixa_Hyslop
Syna Hyslop|Syna_Hyslop
Randolph Keitch|Randolph_Keitch
Levina Monkstanley|Levina_Monkstanley
Orabella Nuttley|Orabella_Nuttley
Urquhart Rackharrow|Urquhart_Rackharrow
Scarpin|Scarpin
Elliot Smethwyck|Elliot_Smethwyck
Wakefield (spell inventor)|Wakefield_(spell_inventor)
Gilbert Wimple|Gilbert_Wimple
Martino Frolic|Martino_Frolic
My Teeth|My_Teeth
Sam (dog)|Sam_(dog)
Nicolas Flamel|Nicolas_Flamel
Perenelle Flamel|Perenelle_Flamel
Kreacher|Kreacher
Amarillo Lestoat|Amarillo_Lestoat
Griselda Marchbanks|Griselda_Marchbanks
Muriel|Muriel
Isolt Sayre|Isolt_Sayre
Faris Spavin|Faris_Spavin
James Steward|James_Steward
Trolley witch|Trolley_witch
Barry Winkle|Barry_Winkle
Antioch Peverell's killer|Antioch_Peverell%27s_killer
Barnabas Deverill|Barnabas_Deverill
Egbert the Egregious|Egbert_the_Egregious
Emeric the Evil|Emeric_the_Evil
Godelot|Godelot
Mykew Gregorovitch|Mykew_Gregorovitch
Hereward|Hereward
Livius|Livius
Loxias|Loxias
Antioch Peverell|Antioch_Peverell
Arcus|Arcus
Bertie Bott|Bertie_Bott
Dehoff|Dehoff
Drooble|Drooble
Filibuster|Filibuster
Finch|Finch
Golpalott|Golpalott
Gregory the Smarmy|Gregory_the_Smarmy
Alberic Grunnion|Alberic_Grunnion
Glover Hipworth|Glover_Hipworth
Linfred of Stinchcombe|Linfred_of_Stinchcombe
Spindle|Spindle
Ubbly|Ubbly
Leonardo Da Vinci|Leonardo_Da_Vinci
Regulus Moonshine|Regulus_Moonshine
Mahoutokoro potions champion|Mahoutokoro_potions_champion
Uagadou potions champion|Uagadou_potions_champion
Brutus|Brutus
Catchpole|Catchpole
David (saint)|David_(saint)
Grogory|Grogory
Hedwig (wizard)|Hedwig_(wizard)
Jerome|Jerome
John|John
Luke|Luke
Mark|Mark
Mary|Mary
Matthew|Matthew
Thomas More|Thomas_More
Oswald|Oswald
Viktor Krum|Viktor_Krum
Dorian Fungbury|Dorian_Fungbury
Elizabeth Smudgling|Elizabeth_Smudgling
Podric Batworthy|Podric_Batworthy
Arcturus Black III|Arcturus_Black_III
Cottismore Croyne|Cottismore_Croyne
Peter Pettigrew's mother|Peter_Pettigrew%27s_mother
Albert Stump|Albert_Stump
Blood traitor|Blood_traitor
Charity Burbage|Charity_Burbage
Percival Dumbledore|Percival_Dumbledore
Seamus Finnigan's mother|Seamus_Finnigan%27s_mother
Alice Longbottom|Alice_Longbottom
Frank Longbottom|Frank_Longbottom
Nigel|Nigel
Gervaise Ollivander|Gervaise_Ollivander
Order of the Phoenix|Order_of_the_Phoenix
Prewett family|Prewett_family
Fabian Prewett|Fabian_Prewett
Gideon Prewett|Gideon_Prewett
William Sayre|William_Sayre
Dean Thomas's father|Dean_Thomas%27s_father
Weasley family|Weasley_family
Percy Weasley|Percy_Weasley
Septimus Weasley|Septimus_Weasley
Bowman Wright's mother|Bowman_Wright%27s_mother
Doris Purkiss|Doris_Purkiss
Rita Skeeter|Rita_Skeeter
Borgin|Borgin
British Ministry of Magic|British_Ministry_of_Magic
Charmed skeleton|Charmed_skeleton
Daily Prophet|Daily_Prophet
Death Eaters's Giant army in First Wizarding War|Death_Eaters%27s_Giant_army_in_First_Wizarding_War
Dementor|Dementor
Penelope Fawley's father|Penelope_Fawley%27s_father
Penelope Fawley's mother|Penelope_Fawley%27s_mother
Giant colony|Giant_colony
Golgomath|Golgomath
Inferius|Inferius
James and Lily Potter's Muggle betrayer|James_and_Lily_Potter%27s_Muggle_betrayer
Marius|Marius
Muggle-Born Registration Commission|Muggle-Born_Registration_Commission
Pyrites|Pyrites
Teffington|Teffington
Pius Thicknesse|Pius_Thicknesse
Unidentified Giant in the Battle of Hogwarts (I)|Unidentified_Giant_in_the_Battle_of_Hogwarts_(I)
Unidentified Giant in the Battle of Hogwarts (II)|Unidentified_Giant_in_the_Battle_of_Hogwarts_(II)
Unidentified Giant in the Battle of Hogwarts (III)|Unidentified_Giant_in_the_Battle_of_Hogwarts_(III)
Unidentified Giant in the Battle of Hogwarts (IV)|Unidentified_Giant_in_the_Battle_of_Hogwarts_(IV)
Unidentified Giant in the Battle of Hogwarts (V)|Unidentified_Giant_in_the_Battle_of_Hogwarts_(V)
Unidentified goblin killed by Voldemort|Unidentified_goblin_killed_by_Voldemort
Unidentified Gringotts guard (I)|Unidentified_Gringotts_guard_(I)
Werewolf army|Werewolf_army
Wizarding Wireless Network News|Wizarding_Wireless_Network_News
Fenrir Greyback's Snatcher gang|Fenrir_Greyback%27s_Snatcher_gang
Fenrir Greyback|Fenrir_Greyback
Snatchers|Snatchers
Chief Snatcher|Chief_Snatcher
Foul-smelling Snatcher|Foul-smelling_Snatcher
Three unidentified Snatchers who disintegrated during the Battle of Hogwarts|Three_unidentified_Snatchers_who_disintegrated_during_the_Battle_of_Hogwarts
Unidentified female Snatcher during the Battle of Hogwarts|Unidentified_female_Snatcher_during_the_Battle_of_Hogwarts
Unidentified Male Snatcher at Diagon Alley|Unidentified_Male_Snatcher_at_Diagon_Alley
Unidentified Male Snatcher during the Battle of Hogwarts|Unidentified_Male_Snatcher_during_the_Battle_of_Hogwarts
Unidentified Snatcher|Unidentified_Snatcher
Unidentified Snatcher (II)|Unidentified_Snatcher_(II)
Unidentified Snatcher (III)|Unidentified_Snatcher_(III)
Unidentified Snatcher (V)|Unidentified_Snatcher_(V)
Alliance|Alliance
Gellert Grindelwald's acolytes|Gellert_Grindelwald%27s_acolytes
Acolyte thug|Acolyte_thug
Carrow (1920s)|Carrow_(1920s)
Gunnar Grimmson|Gunnar_Grimmson
Krafft|Krafft
Krall|Krall
MacDuff|MacDuff
Nagel|Nagel
Vinda Rosier|Vinda_Rosier
Unidentified Acolyte|Unidentified_Acolyte
Angus|Angus
Justin Finch-Fletchley's mother|Justin_Finch-Fletchley%27s_mother
Gilderoy Lockhart's helper|Gilderoy_Lockhart%27s_helper
Gladys Gudgeon|Gladys_Gudgeon
Gilderoy Lockhart's mother|Gilderoy_Lockhart%27s_mother
Veronica Smethley|Veronica_Smethley
Unidentified fans of Gilderoy Lockhart|Unidentified_fans_of_Gilderoy_Lockhart
Barny the Fruitbat|Barny_the_Fruitbat
Curupira|Curupira
Dukuwaqa|Dukuwaqa
Genie|Genie
Hebridean Black|Hebridean_Black
Leprechaun|Leprechaun
Loch Ness Monster|Loch_Ness_Monster
Sasabonsam|Sasabonsam
Selma|Selma
Troll|Troll
Veela|Veela
Badger|Badger
Eagle|Eagle
Golden eagle|Golden_eagle
Horned Serpent|Horned_Serpent
Lion|Lion
Pukwudgie|Pukwudgie
Snake|Snake
Thunderbird|Thunderbird
Wampus cat|Wampus_cat
Inquisitorial Squad|Inquisitorial_Squad
International Confederation of Wizards|International_Confederation_of_Wizards
Yusuf Kama|Yusuf_Kama
Willy Widdershins|Willy_Widdershins
Druella Black|Druella_Black
Death Eaters|Death_Eaters
Antonin Dolohov|Antonin_Dolohov
Barrett Fay|Barrett_Fay
Corvus Lestrange (IV)|Corvus_Lestrange_(IV)
Sinistra Lowe|Sinistra_Lowe
Brutus Malfoy|Brutus_Malfoy
Slytherin family|Slytherin_family
Travers|Travers
Corban Yaxley|Corban_Yaxley
Chudley Cannons Fan Club|Chudley_Cannons_Fan_Club
Barnaby Snell|Barnaby_Snell
Freckle-faced six-year-old|Freckle-faced_six-year-old
Matilda Dukelow|Matilda_Dukelow
Donaghan Tremlett|Donaghan_Tremlett
Randolph Pauncefoot|Randolph_Pauncefoot
Sidney Todd|Sidney_Todd
Timothy Blenkinsop|Timothy_Blenkinsop
Swoopstikes|Swoopstikes
Walter Parkin|Walter_Parkin
Kennilworthy Whisp|Kennilworthy_Whisp
Augustus Rookwood|Augustus_Rookwood
Old Posh Baron|Old_Posh_Baron
Bedivere|Bedivere
Lord Byron|Lord_Byron
Winston Churchill|Winston_Churchill
Count|Count
Patrick Delaney-Podmore|Patrick_Delaney-Podmore
Arthur Conan Doyle|Arthur_Conan_Doyle
Lord Draben|Lord_Draben
Duke of Wellington|Duke_of_Wellington
Google Flange|Google_Flange
Lady Grieve|Lady_Grieve
Knight with an arrow sticking out of his forehead|Knight_with_an_arrow_sticking_out_of_his_forehead
Jan Kowalski|Jan_Kowalski
Lancelot (knight)|Lancelot_(knight)
Menzies|Menzies
Mona Lisa|Mona_Lisa
Lord North|Lord_North
Lord Palmerston|Lord_Palmerston
Earl of Paunchley|Earl_of_Paunchley
Percivale|Percivale
J. C. M. van Riemsdijk|J._C._M._van_Riemsdijk
African prince|African_prince
Arthur|Arthur
Anne Boleyn|Anne_Boleyn
David (king)|David_(king)
Elizabeth I|Elizabeth_I
Elizabeth II|Elizabeth_II
George III|George_III
Malodora Grymm's husband|Malodora_Grymm%27s_husband
Henry VI|Henry_VI
Henry VII|Henry_VII
Henry VIII|Henry_VIII
Karkus|Karkus
Karkus's wife|Karkus%27s_wife
King|King
Unidentified King|Unidentified_King
Mary II|Mary_II
Morholt's brother|Morholt%27s_brother
Prince|Prince
Unidentified Princess|Unidentified_Princess
Queen|Queen
Ragnuk|Ragnuk
Richard I|Richard_I
House of Tudor|House_of_Tudor
Victoria|Victoria
William I|William_I
William III|William_III
Sidley Smirk Platter|Sidley_Smirk_Platter
Phyllida Spore|Phyllida_Spore
Tomkins|Tomkins
Vincent Duc de Trefle-Picques|Vincent_Duc_de_Trefle-Picques
Herbert Varney|Herbert_Varney
Vlad the Impaler|Vlad_the_Impaler
Lady Wimborne|Lady_Wimborne
Winogrand|Winogrand
Lisette de Lapin|Lisette_de_Lapin
Le Prevost de Basserode|Le_Prevost_de_Basserode
Abbott|Abbott
Edwin Booth|Edwin_Booth
Ariana Dumbledore|Ariana_Dumbledore
Kendra Dumbledore|Kendra_Dumbledore
Peter G. (Godric's Hollow)|Peter_G._(Godric%27s_Hollow)
M. Kenton|M._Kenton
H. Knighton|H._Knighton
Elsbeth McCormick|Elsbeth_McCormick
Cadmus Peverell|Cadmus_Peverell
Ignotus Peverell|Ignotus_Peverell
Dinah Stevenson|Dinah_Stevenson
John Stevenson|John_Stevenson
R. Wilde Aston|R._Wilde_Aston
D. Williams|D._Williams
Bartemius Crouch Senior|Bartemius_Crouch_Senior
Charles Epanel|Charles_Epanel
Rod Freddy|Rod_Freddy
Peter G. (Little Hangleton)|Peter_G._(Little_Hangleton)
Gulray|Gulray
Philip K.|Philip_K.
A.J. Mennett|A.J._Mennett
Charles Pikal|Charles_Pikal
Rebecca Ramsea|Rebecca_Ramsea
Mary Riddle|Mary_Riddle
Thomas Riddle|Thomas_Riddle
Tom Riddle Senior|Tom_Riddle_Senior
Eddi Stoddy|Eddi_Stoddy
Venusia Crickerly|Venusia_Crickerly
Gibbon|Gibbon
Quintia McQuoid|Quintia_McQuoid
Eloise Mintumble|Eloise_Mintumble
Nagnok|Nagnok
Raczidian|Raczidian
Wilhelmina Tuft|Wilhelmina_Tuft
Elphinstone Urquart|Elphinstone_Urquart
Wizard who killed a Chimaera|Wizard_who_killed_a_Chimaera
Laurena Kama|Laurena_Kama
Binky|Binky
Boot brothers' father|Boot_brothers%27_father
Boot brothers' mother|Boot_brothers%27_mother
Eldon Elsrickle|Eldon_Elsrickle
Dai Llewellyn|Dai_Llewellyn
Montgomery|Montgomery
Scarlett|Scarlett
Credence Barebone's aunt|Credence_Barebone%27s_aunt
Corvus Lestrange (V)|Corvus_Lestrange_(V)
House of Black house-elves|House_of_Black_house-elves
Kreacher's mother|Kreacher%27s_mother
Eldritch Diggory|Eldritch_Diggory
Goldstein sisters' father|Goldstein_sisters%27_father
Goldstein sisters' mother|Goldstein_sisters%27_mother
Euphemia Potter|Euphemia_Potter
Fiery Death Eater|Fiery_Death_Eater
Ghost at Gryffindor Tower|Ghost_at_Gryffindor_Tower
Billy Stubbs's rabbit|Billy_Stubbs%27s_rabbit
Alastor Moody's spiders|Alastor_Moody%27s_spiders
Frank Bryce|Frank_Bryce
Irma Dugard|Irma_Dugard
Fox near Spinner's End|Fox_near_Spinner%27s_End
German-speaking children|German-speaking_children
German-speaking woman|German-speaking_woman
Red-haired young witch|Red-haired_young_witch
Unidentified five Muggles|Unidentified_five_Muggles
Unidentified male bald Death Eater|Unidentified_male_bald_Death_Eater
Unidentified Male Death Eater (VIII)|Unidentified_Male_Death_Eater_(VIII)
Unidentified Non-magique Father|Unidentified_Non-magique_Father
Unidentified Non-magique Mother|Unidentified_Non-magique_Mother
Unidentified Non-magique toddler|Unidentified_Non-magique_toddler
Unidentified wizard killed at the Quad battlements|Unidentified_wizard_killed_at_the_Quad_battlements
Hannah Abbott's mother|Hannah_Abbott%27s_mother
Broderick Bode|Broderick_Bode
Amelia Bones|Amelia_Bones
Amelia Bones' father|Amelia_Bones%27_father
Amelia Bones' mother|Amelia_Bones%27_mother
Edgar Bones|Edgar_Bones
Edgar Bones' children|Edgar_Bones%27_children
Edgar Bones' wife|Edgar_Bones%27_wife
Dougal McGregor's children|Dougal_McGregor%27s_children
Family that lived in Gregorovitch's former home|Family_that_lived_in_Gregorovitch%27s_former_home
Benjy Fenwick|Benjy_Fenwick
Florean Fortescue|Florean_Fortescue
Goblin family near Nottingham|Goblin_family_near_Nottingham
Gornuk|Gornuk
Hall|Hall
Viktor Krum's grandfather|Viktor_Krum%27s_grandfather
Dugald McClivert|Dugald_McClivert
Robert McGonagall Junior|Robert_McGonagall_Junior
Dougal McGregor's wife|Dougal_McGregor%27s_wife
Dougal McGregor|Dougal_McGregor
McKinnon family|McKinnon_family
Marlene McKinnon|Marlene_McKinnon
Mills|Mills
Unidentified Muggle family|Unidentified_Muggle_family
Peter Pettigrew's unidentified victims|Peter_Pettigrew%27s_unidentified_victims
Antioch Peverell's enemy|Antioch_Peverell%27s_enemy
Henry Shaw Junior|Henry_Shaw_Junior
Hamish Steed|Hamish_Steed
Emmeline Vance|Emmeline_Vance
Westenberg|Westenberg
Westenberg's wife|Westenberg%27s_wife
Talbott Winger's father|Talbott_Winger%27s_father
Cyprian Youdle|Cyprian_Youdle
Albanian peasant|Albanian_peasant
Muggle tramp|Muggle_tramp
Hepzibah Smith|Hepzibah_Smith
Edmund Grubb|Edmund_Grubb
Jacob Kowalski's brother|Jacob_Kowalski%27s_brother
Fallen Fifty|Fallen_Fifty
Unidentified Black Death Eater at the Battle of Hogwarts (II)|Unidentified_Black_Death_Eater_at_the_Battle_of_Hogwarts_(II)
Unidentified Death Eater killed by Kingsley Shacklebolt|Unidentified_Death_Eater_killed_by_Kingsley_Shacklebolt
Unidentified female Hogwarts teacher|Unidentified_female_Hogwarts_teacher
Unidentified Hogsmeade Death Eater (II)|Unidentified_Hogsmeade_Death_Eater_(II)
Unidentified Hogwarts students killed on the Seventh Floor|Unidentified_Hogwarts_students_killed_on_the_Seventh_Floor
Unidentified male Death Eater during the Battle of Hogwarts (IV)|Unidentified_male_Death_Eater_during_the_Battle_of_Hogwarts_(IV)
Unidentified male Death Eater killed by a grey haired wizard|Unidentified_male_Death_Eater_killed_by_a_grey_haired_wizard
Unidentified male Death Eater killed on the Hogwarts Seventh Floor|Unidentified_male_Death_Eater_killed_on_the_Hogwarts_Seventh_Floor
Unidentified man killed in the courtyard explosion|Unidentified_man_killed_in_the_courtyard_explosion
Lucretia Fawley|Lucretia_Fawley
Marshall Fawley|Marshall_Fawley
Vargot|Vargot
Alexander Pope|Alexander_Pope
Arcturus Black II|Arcturus_Black_II
Belvina Black|Belvina_Black
Cygnus Black II|Cygnus_Black_II
Misapinoa Black|Misapinoa_Black
Phoebe Black|Phoebe_Black
Sirius Black II|Sirius_Black_II
Blaise Zabini's mother's seven husbands|Blaise_Zabini%27s_mother%27s_seven_husbands
Petunia Dursley|Petunia_Dursley
Ekrizdis|Ekrizdis
Erling|Erling
Evans sisters' father|Evans_sisters%27_father
Evans sisters' mother|Evans_sisters%27_mother
Frank Longbottom's father|Frank_Longbottom%27s_father
Frazier|Frazier
Fridwulfa|Fridwulfa
Godfrey|Godfrey
Rubeus Hagrid's father|Rubeus_Hagrid%27s_father
Mustafa Kama|Mustafa_Kama
Clarisse Lestrange|Clarisse_Lestrange
Ermessende Lestrange|Ermessende_Lestrange
Fortunade Lestrange|Fortunade_Lestrange
Gaidic Lestrange|Gaidic_Lestrange
Erich Ludendorff|Erich_Ludendorff
Lucius Malfoy I|Lucius_Malfoy_I
Napier|Napier
Niko Nenad|Niko_Nenad
Theodore Nott's mother|Theodore_Nott%27s_mother
Ignotus Peverell's son|Ignotus_Peverell%27s_son
Portrait of a Healer in St Mungo's Hospital|Portrait_of_a_Healer_in_St_Mungo%27s_Hospital
Henry Potter's mother|Henry_Potter%27s_mother
Xavier Rastrick|Xavier_Rastrick
Rubeus Hagrid's chickens|Rubeus_Hagrid%27s_chickens
Horace Slughorn's father|Horace_Slughorn%27s_father
Albert Tillyman|Albert_Tillyman
First semi-finalist of the 1379 duelling contest|First_semi-finalist_of_the_1379_duelling_contest
Second semi-finalist of the 1379 duelling contest|Second_semi-finalist_of_the_1379_duelling_contest
Gifford Ollerton|Gifford_Ollerton
Cecilia Gallerani|Cecilia_Gallerani
Quong Po|Quong_Po
Nicolaus Copernicus|Nicolaus_Copernicus
Martha Steward|Martha_Steward
William Shakespeare|William_Shakespeare
Archibald Alderton|Archibald_Alderton
Galileo Galilei|Galileo_Galilei
John Bunyan|John_Bunyan
Thaddeus Thurkell|Thaddeus_Thurkell
Almeric Sawbridge|Almeric_Sawbridge
Mercy Lewis|Mercy_Lewis
Abraham Peasegood|Abraham_Peasegood
Sea Serpent of Cromer|Sea_Serpent_of_Cromer
Isaac Newton|Isaac_Newton
Deliverance Dane|Deliverance_Dane
Gideon Flatworthy|Gideon_Flatworthy
Honoria Nutcombe|Honoria_Nutcombe
Dilys Derwent|Dilys_Derwent
Maximilian Crowdy|Maximilian_Crowdy
Wolfgang Amadeus Mozart|Wolfgang_Amadeus_Mozart
Bilius|Bilius
Alexia Walkin Black|Alexia_Walkin_Black
Hesper Black|Hesper_Black
Violetta Bulstrode|Violetta_Bulstrode
Irma Crabbe|Irma_Crabbe
Caspar Crouch|Caspar_Crouch
Hesper Gamp|Hesper_Gamp
Hokey|Hokey
Hope Howell|Hope_Howell
Melania Macmillan|Melania_Macmillan
Bob Ogden|Bob_Ogden
Charlus Potter|Charlus_Potter
Henry Potter|Henry_Potter
Lysandra Yaxley|Lysandra_Yaxley
William McGonagall|William_McGonagall
Leopoldina Smethwyck|Leopoldina_Smethwyck
Bram Stoker|Bram_Stoker
Walter Crane|Walter_Crane
Katherine Mansfield|Katherine_Mansfield
Edith Nesbit|Edith_Nesbit
Georges Clemenceau|Georges_Clemenceau
Elladora Black|Elladora_Black
Edgar Wallace|Edgar_Wallace
Richard Washburn Child|Richard_Washburn_Child
Eunice Murray|Eunice_Murray
Charles Dana Gibson|Charles_Dana_Gibson
George Orwell|George_Orwell
Albert Einstein|Albert_Einstein
Regulus Black I|Regulus_Black_I
Lycoris Black|Lycoris_Black
Picasso|Picasso
Paul Gallico|Paul_Gallico
Francis|Francis
Adalbert Waffling|Adalbert_Waffling
Pollux Black|Pollux_Black
Dodie Smith|Dodie_Smith
Unidentified broom flyer|Unidentified_broom_flyer
Unidentified bluebird|Unidentified_bluebird
Carl Sagan|Carl_Sagan
Demetrius Prod|Demetrius_Prod
Barnabus Blenkinsop|Barnabus_Blenkinsop
Joseph Heller|Joseph_Heller
Cho Chang's grandfather|Cho_Chang%27s_grandfather
Newton Scamander's nifflers|Newton_Scamander%27s_nifflers
Acromantula|Acromantula
Bald Healer|Bald_Healer
Bane|Bane
Centaur|Centaur
Devil's Snare|Devil%27s_Snare
Dumbledore's Army|Dumbledore%27s_Army
Fang|Fang
First-Floor Fighter|First-Floor_Fighter
Forbidden Forest Acromantula colony|Forbidden_Forest_Acromantula_colony
Forbidden Forest Centaur colony|Forbidden_Forest_Centaur_colony
Giant|Giant
Headless Hunt|Headless_Hunt
Hogwartian|Hogwartian
Hogwarts house-elves|Hogwarts_house-elves
Hogwarts Thestral herd|Hogwarts_Thestral_herd
House-elf|House-elf
Walden Macnair|Walden_Macnair
Magorian|Magorian
Mandrake|Mandrake
Oliver Wood's friends|Oliver_Wood%27s_friends
Poppy Pomfrey|Poppy_Pomfrey
Poppy Pomfrey's Death Eater Opponent|Poppy_Pomfrey%27s_Death_Eater_Opponent
Ronan|Ronan
Thorfinn Rowle|Thorfinn_Rowle
Snargaluff|Snargaluff
Squat, wheezy man|Squat,_wheezy_man
Stunned Death Eater|Stunned_Death_Eater
Suit of armour|Suit_of_armour
Thestral|Thestral
Unidentified Acromantula Commander during Battle of Hogwarts|Unidentified_Acromantula_Commander_during_Battle_of_Hogwarts
Unidentified Black Death Eater at the Battle of Hogwarts|Unidentified_Black_Death_Eater_at_the_Battle_of_Hogwarts
Unidentified black wizard during the Battle of Hogwarts|Unidentified_black_wizard_during_the_Battle_of_Hogwarts
Unidentified Death Eater in the Forbidden Forest|Unidentified_Death_Eater_in_the_Forbidden_Forest
Unidentified Death Eater stunned by Harry Potter in the Grand Staircase Tower|Unidentified_Death_Eater_stunned_by_Harry_Potter_in_the_Grand_Staircase_Tower
Unidentified Death Eater that was Stunned by Harry Potter|Unidentified_Death_Eater_that_was_Stunned_by_Harry_Potter
Unidentified Death Eater who engaged Arthur Weasley|Unidentified_Death_Eater_who_engaged_Arthur_Weasley
Unidentified Death Eater who fought in a First Floor Corridor (II)|Unidentified_Death_Eater_who_fought_in_a_First_Floor_Corridor_(II)
Unidentified Death Eater who tortured a wizard|Unidentified_Death_Eater_who_tortured_a_wizard
Unidentified female Death Eater at Malfoy Manor (II)|Unidentified_female_Death_Eater_at_Malfoy_Manor_(II)
Unidentified grey haired man during the Battle of Hogwarts|Unidentified_grey_haired_man_during_the_Battle_of_Hogwarts
Unidentified hiding wizard during the Battle of Hogwarts|Unidentified_hiding_wizard_during_the_Battle_of_Hogwarts
Unidentified Hogsmeade Death Eater (I)|Unidentified_Hogsmeade_Death_Eater_(I)
Unidentified Hogwartian in a pointed hat during the Battle of Hogwarts|Unidentified_Hogwartian_in_a_pointed_hat_during_the_Battle_of_Hogwarts
Unidentified Light Male Death Eater (I)|Unidentified_Light_Male_Death_Eater_(I)
Unidentified Male Death Eater (I)|Unidentified_Male_Death_Eater_(I)
Unidentified male Death Eater at Malfoy Manor (II)|Unidentified_male_Death_Eater_at_Malfoy_Manor_(II)
Unidentified male Death Eater during the Battle of Hogwarts|Unidentified_male_Death_Eater_during_the_Battle_of_Hogwarts
Unidentified male Death Eater during the Battle of Hogwarts (III)|Unidentified_male_Death_Eater_during_the_Battle_of_Hogwarts_(III)
Unidentified man in a grey suit during the Battle of Hogwarts|Unidentified_man_in_a_grey_suit_during_the_Battle_of_Hogwarts
Unidentified old woman during the Battle of Hogwarts|Unidentified_old_woman_during_the_Battle_of_Hogwarts
Unidentified white haired wizard during the Battle of Hogwarts|Unidentified_white_haired_wizard_during_the_Battle_of_Hogwarts
Unidentified woman in a red dress during the Battle of Hogwarts|Unidentified_woman_in_a_red_dress_during_the_Battle_of_Hogwarts
Venomous Tentacula|Venomous_Tentacula
Wainscott|Wainscott
Werewolf|Werewolf
White-Haired Healer|White-Haired_Healer
Woman Tended by Bald Man|Woman_Tended_by_Bald_Man
Unidentified male Auror at Hogwarts|Unidentified_male_Auror_at_Hogwarts
Crabbe|Crabbe
Jugson|Jugson
Rabastan Lestrange|Rabastan_Lestrange
Unidentified Death Eater knocked out by Alastor Moody|Unidentified_Death_Eater_knocked_out_by_Alastor_Moody
Hedwig's killer|Hedwig%27s_killer
Selwyn|Selwyn
Zygmunt Budge's mother|Zygmunt_Budge%27s_mother
Corrine Cribb|Corrine_Cribb
Dennis|Dennis
Dudley Dursley's Gang|Dudley_Dursley%27s_Gang
Gordon|Gordon
Malcolm|Malcolm
Piers Polkiss|Piers_Polkiss
Marjorie Dursley|Marjorie_Dursley
Vernon Dursley|Vernon_Dursley
Little Hangleton boys|Little_Hangleton_boys
Skender|Skender
Three Aurors who tried to arrest Rubeus Hagrid|Three_Aurors_who_tried_to_arrest_Rubeus_Hagrid
Mulciber I|Mulciber_I
Rosier (male)|Rosier_(male)
Torquil Travers|Torquil_Travers
Unidentified Mould-on-the-Wold boys|Unidentified_Mould-on-the-Wold_boys
Unidentified St Mungo's patient's brother|Unidentified_St_Mungo%27s_patient%27s_brother
Assassin|Assassin
Damien Bandrel|Damien_Bandrel
William Friend|William_Friend
Ginger Witch|Ginger_Witch
John Haas|John_Haas
Herschel Haesito|Herschel_Haesito
Raymund Lambus|Raymund_Lambus
Eduardus Limus (criminal)|Eduardus_Limus_(criminal)
Alberto Macellarius|Alberto_Macellarius
Mundungus Fletcher's associate|Mundungus_Fletcher%27s_associate
Charlesetta Nagy|Charlesetta_Nagy
Lim Po|Lim_Po
Tabitha Tabella|Tabitha_Tabella
Janus Thickey|Janus_Thickey
Abel Treetops|Abel_Treetops
Unidentified Amulet-seller in Diagon Alley|Unidentified_Amulet-seller_in_Diagon_Alley
Willy Wagstaff|Willy_Wagstaff
Alderton|Alderton
Arkie Alderton's alleged son|Arkie_Alderton%27s_alleged_son
Unidentified Azkaban Escapee|Unidentified_Azkaban_Escapee
Crispin Cronk|Crispin_Cronk
Page siblings' mother|Page_siblings%27_mother
Sturgis Podmore|Sturgis_Podmore
Bartholomew Barebone|Bartholomew_Barebone
Hodrod the Horny-Handed|Hodrod_the_Horny-Handed
Matildus Heizenbert|Matildus_Heizenbert
Miraforum (American witch)|Miraforum_(American_witch)
Eleanora Shanks|Eleanora_Shanks
Page siblings' father|Page_siblings%27_father
Reggie Page|Reggie_Page
Dorcus Twelvetrees|Dorcus_Twelvetrees
Female Death Eater at the Graveyard|Female_Death_Eater_at_the_Graveyard
Unidentified Male Death Eater (II)|Unidentified_Male_Death_Eater_(II)
Unidentified Male Death Eater (X)|Unidentified_Male_Death_Eater_(X)
Unidentified Death Eater (Quidditch World Cup 1994)|Unidentified_Death_Eater_(Quidditch_World_Cup_1994)
Unidentified female Death Eater at Malfoy Manor (I)|Unidentified_female_Death_Eater_at_Malfoy_Manor_(I)
Unidentified male Death Eater at Malfoy Manor|Unidentified_male_Death_Eater_at_Malfoy_Manor
Unidentified Male Death Eater at the Little Hangleton graveyard (I)|Unidentified_Male_Death_Eater_at_the_Little_Hangleton_graveyard_(I)
Unidentified male Death Eater during the Battle of Hogwarts (II)|Unidentified_male_Death_Eater_during_the_Battle_of_Hogwarts_(II)
Unidentified three Death Eaters|Unidentified_three_Death_Eaters
Dark Mark|Dark_Mark
Goyle|Goyle
Barnaby Lee's father|Barnaby_Lee%27s_father
Barnaby Lee's mother|Barnaby_Lee%27s_mother
Lemus Pinutius|Lemus_Pinutius
Unidentified Portkey tout|Unidentified_Portkey_tout
Alexandra Walker|Alexandra_Walker
Will|Will
Court Scribe|Court_Scribe
Arabella Figg|Arabella_Figg
Owle Bullock|Owle_Bullock
J. K. Rowling (in-universe)|J._K._Rowling_(in-universe)
Greek man|Greek_man
Mountain troll|Mountain_troll
Norberta|Norberta
Quirinus Quirrell's first mountain troll|Quirinus_Quirrell%27s_first_mountain_troll
Quirinus Quirrell's second mountain troll|Quirinus_Quirrell%27s_second_mountain_troll
Unicorn|Unicorn
Unidentified Gringotts spokesgoblin|Unidentified_Gringotts_spokesgoblin
Secret Keeper|Secret_Keeper
Unidentified bird in bell jar|Unidentified_bird_in_bell_jar
Un-born|Un-born
Hugo Granger-Weasley|Hugo_Granger-Weasley
Abraham|Abraham
Andros the Invincible|Andros_the_Invincible
Goliath's slayer|Goliath%27s_slayer
Isaac|Isaac
Isaiah|Isaiah
Jesus|Jesus
Odysseus|Odysseus
Ollivander (382 B.C. era)|Ollivander_(382_B.C._era)
Dzou Yen|Dzou_Yen
Henry Bumblepuft|Henry_Bumblepuft
Poderick Cruickshank|Poderick_Cruickshank
Beedle the Bard|Beedle_the_Bard
Hannah Cockleford|Hannah_Cockleford
Edmund Gaddlegate's mother|Edmund_Gaddlegate%27s_mother
Edmund Gaddlegate|Edmund_Gaddlegate
Poderick Crookshank|Poderick_Crookshank
Josiah Jackson|Josiah_Jackson
Abraham Potter|Abraham_Potter
Thurkell brothers|Thurkell_brothers
Unidentified Wampanoag children|Unidentified_Wampanoag_children
Charity Wilkinson|Charity_Wilkinson
Licorus Black|Licorus_Black
Charles Dickens|Charles_Dickens
George Eliot|George_Eliot
Cygnus Black I|Cygnus_Black_I
Arcturus Black I|Arcturus_Black_I
R. L. Stevenson|R._L._Stevenson
Warren G. Harding|Warren_G._Harding
Charles Demengeot|Charles_Demengeot
Violet Tillyman's children|Violet_Tillyman%27s_children
Roland Kegg|Roland_Kegg
Cole|Cole
Angus McMangus|Angus_McMangus
Blodwyn Bludd|Blodwyn_Bludd
Unidentified orphan|Unidentified_orphan
Caractacus Phelps|Caractacus_Phelps
Lucy Evans|Lucy_Evans
Stephen Hawking|Stephen_Hawking
Oliver Wiseman|Oliver_Wiseman
Roddy Doyle|Roddy_Doyle
Glenda Chittock|Glenda_Chittock
Heathcote Barbary|Heathcote_Barbary
Penelope Taylor|Penelope_Taylor
Herman Wintringham|Herman_Wintringham
Orsino Thruston|Orsino_Thruston
David Boorman I|David_Boorman_I
Dobbin|Dobbin
Eekins|Eekins
Jake Flinton|Jake_Flinton
Cyril Meakin|Cyril_Meakin
Kevin Sterndale|Kevin_Sterndale
Unidentified Gryffindor prefect|Unidentified_Gryffindor_prefect
Mervyn Wynch|Mervyn_Wynch
Kelly Brown|Kelly_Brown
Jim Hamilton|Jim_Hamilton
Unidentified 8-year-old Muggle girl|Unidentified_8-year-old_Muggle_girl
Gabrielle Delacour|Gabrielle_Delacour
Derek|Derek
Emma Dobbs|Emma_Dobbs
Mark Evans|Mark_Evans
Girl who tested Fainting Fancies|Girl_who_tested_Fainting_Fancies
Unidentified fourth year student|Unidentified_fourth_year_student
Unidentified ten-year-old|Unidentified_ten-year-old
Stuart Hogg|Stuart_Hogg
Jack Monk|Jack_Monk
Tom Monk|Tom_Monk
Egmont Hobday|Egmont_Hobday
Griselda Jorkins|Griselda_Jorkins
Kevin|Kevin
Ngapo Ponika|Ngapo_Ponika
Two little witches|Two_little_witches
Annis Black|Annis_Black
Araminta Meliflua Black|Araminta_Meliflua_Black
Eurig Cadwallader|Eurig_Cadwallader
Alfred Cattermole|Alfred_Cattermole
Ellie Cattermole|Ellie_Cattermole
Maisie Cattermole|Maisie_Cattermole
Darren Floyd|Darren_Floyd
Matthew Echunga|Matthew_Echunga
Minaka Hirakata|Minaka_Hirakata
Stephan Hodhedge|Stephan_Hodhedge
Masaki Hongo|Masaki_Hongo
Tamotsu Iwamoto|Tamotsu_Iwamoto
Janus Thickey's children|Janus_Thickey%27s_children
Rowan Khanna's brother|Rowan_Khanna%27s_brother
Kimiko Kurosawa|Kimiko_Kurosawa
Bogomil Levski|Bogomil_Levski
Gilderoy Lockhart's sisters|Gilderoy_Lockhart%27s_sisters
Asgard Pettersson|Asgard_Pettersson
Thorsten Pfeffer|Thorsten_Pfeffer
Constance Pickering's brother (I)|Constance_Pickering%27s_brother_(I)
Constance Pickering's sister|Constance_Pickering%27s_sister
Lucas Picquery|Lucas_Picquery
Prime Minister's niece|Prime_Minister%27s_niece
Samuel G. Quahog|Samuel_G._Quahog
Roberts children|Roberts_children
Runcorn|Runcorn
Noriko Sato|Noriko_Sato
Rolf Scamander|Rolf_Scamander
Shintaro Shingo|Shintaro_Shingo
Yoshihiro Suzuki|Yoshihiro_Suzuki
Ryotaro Tanaka|Ryotaro_Tanaka
Dean Thomas's half-siblings|Dean_Thomas%27s_half-siblings
Tiberius|Tiberius
Todoroki|Todoroki
Liz Tuttle's sister|Liz_Tuttle%27s_sister
Unidentified boy with birthmark|Unidentified_boy_with_birthmark
Unidentified poor boy|Unidentified_poor_boy
Unidentified Puking Pastilles Victim|Unidentified_Puking_Pastilles_Victim
Yoshi Wakahisa|Yoshi_Wakahisa
Willi Wenzel|Willi_Wenzel
Ryan Westrup|Ryan_Westrup
Eric Whalley|Eric_Whalley
William Weasley's South American pen-friend|William_Weasley%27s_South_American_pen-friend
Ryuichi Yamaguchi|Ryuichi_Yamaguchi
Rawya Zaghloul|Rawya_Zaghloul
Addison Fawley|Addison_Fawley
Melody Fawley|Melody_Fawley
Jay|Jay
Jay's friend|Jay%27s_friend
Unidentified blond twin boys at Platform Nine and Three Quarters|Unidentified_blond_twin_boys_at_Platform_Nine_and_Three_Quarters
Dudley Dursley's children|Dudley_Dursley%27s_children
Lorcan Scamander|Lorcan_Scamander
Lysander Scamander|Lysander_Scamander
Dominique Weasley|Dominique_Weasley
Louis Weasley|Louis_Weasley
Lucy Weasley|Lucy_Weasley
Molly Weasley II|Molly_Weasley_II
16th century Potions Professor|16th_century_Potions_Professor
Architect of Hogwarts|Architect_of_Hogwarts
Silvio Astolfi|Silvio_Astolfi
Bartholomew|Bartholomew
Angel|Angel
Angel of Death|Angel_of_Death
Devil|Devil
God|God
Pierre Bonaccord|Pierre_Bonaccord
Bonhabille|Bonhabille
Albert Boot|Albert_Boot
Webster Boot's wife|Webster_Boot%27s_wife
Barberus Bragge|Barberus_Bragge
Cadogan's children|Cadogan%27s_children
Cadogan's ex-wives|Cadogan%27s_ex-wives
Cadogan's father|Cadogan%27s_father
Cadogan's mother|Cadogan%27s_mother
Josefina Calderon|Josefina_Calderon
Calid|Calid
Rancorous Carpe|Rancorous_Carpe
Edgar Cloggs|Edgar_Cloggs
Elfrida Cragg|Elfrida_Cragg
Lucy Crane|Lucy_Crane
Priscilla Dupont|Priscilla_Dupont
Earl of Paunchley's four burly servants|Earl_of_Paunchley%27s_four_burly_servants
Elfric the Eager|Elfric_the_Eager
Eliana|Eliana
Everard|Everard
Archer Evermonde|Archer_Evermonde
Wilhelm Fischer|Wilhelm_Fischer
Basil Flack|Basil_Flack
Able Fleming|Able_Fleming
Josephina Flint|Josephina_Flint
Theodard Fontaine|Theodard_Fontaine
Fortinbras|Fortinbras
Ottaline Gambol|Ottaline_Gambol
Josette Gage|Josette_Gage
Hesphaestus Gore|Hesphaestus_Gore
Gondulphus Graves|Gondulphus_Graves
Brothers Grimm|Brothers_Grimm
Robert Grimsditch|Robert_Grimsditch
Thornton Harkaway|Thornton_Harkaway
Headmaster of Durmstrang Institute during 1792|Headmaster_of_Durmstrang_Institute_during_1792
First Headmaster of Hogwarts|First_Headmaster_of_Hogwarts
Headteacher of Beauxbatons Academy of Magic during 1792|Headteacher_of_Beauxbatons_Academy_of_Magic_during_1792
Headteacher of Hogwarts School of Witchcraft and Wizardry during 1792|Headteacher_of_Hogwarts_School_of_Witchcraft_and_Wizardry_during_1792
Hankerton Humble|Hankerton_Humble
Illyius|Illyius
Ingolfr the Iambic|Ingolfr_the_Iambic
Jack|Jack
Jasichus|Jasichus
Mary Jauncey|Mary_Jauncey
Porteus Knatchbull|Porteus_Knatchbull
Goodwin Kneen|Goodwin_Kneen
Lachlan the Lanky|Lachlan_the_Lanky
Corvus Lestrange (I)|Corvus_Lestrange_(I)
Corvus Lestrange (III)|Corvus_Lestrange_(III)
Cyrille Lestrange (I)|Cyrille_Lestrange_(I)
Eglantine Lestrange|Eglantine_Lestrange
Falco Lestrange|Falco_Lestrange
Heloise Lestrange|Heloise_Lestrange
Radolphus Lestrange|Radolphus_Lestrange
Guthrie Lochrin|Guthrie_Lochrin
Carlos Lopez|Carlos_Lopez
Mungo MacDuff|Mungo_MacDuff
Malecrit|Malecrit
Nicholas Malfoy|Nicholas_Malfoy
Septimus Malfoy|Septimus_Malfoy
Malodora Grymm's victim|Malodora_Grymm%27s_victim
Martha Steward II's friend|Martha_Steward_II%27s_friend
Elizabeth McGilliguddy|Elizabeth_McGilliguddy
Torquil McTavish|Torquil_McTavish
Hortensia Milliphutt|Hortensia_Milliphutt
Eupraxia Mole|Eupraxia_Mole
Maerwynn Montfort|Maerwynn_Montfort
Harfang Munter|Harfang_Munter
Cormac O'Brien|Cormac_O%27Brien
Geraint Ollivander|Geraint_Ollivander
Gerbold Ollivander|Gerbold_Ollivander
Oona|Oona
Evangeline Orpington|Evangeline_Orpington
Unctuous Osbert|Unctuous_Osbert
Myron Otherhaus|Myron_Otherhaus
Parkin (Beater I)|Parkin_(Beater_I)
Parkin (Beater II)|Parkin_(Beater_II)
Parkin (Chaser I)|Parkin_(Chaser_I)
Parkin (Chaser II)|Parkin_(Chaser_II)
Parkin (Chaser III)|Parkin_(Chaser_III)
Parkin (Keeper)|Parkin_(Keeper)
Parkin (Seeker)|Parkin_(Seeker)
Perseus Parkinson|Perseus_Parkinson
Manon Perrot|Manon_Perrot
Iolanthe Peverell|Iolanthe_Peverell
Prudence|Prudence
Ptolemy|Ptolemy
Pythagoras|Pythagoras
Modesty Rabnott|Modesty_Rabnott
Emily Rappaport|Emily_Rappaport
Berthilde Roche|Berthilde_Roche
Damocles Rowle|Damocles_Rowle
Snickerton|Snickerton
Catullus Spangle|Catullus_Spangle
Rionach Steward|Rionach_Steward
Google Stump|Google_Stump
Tertius|Tertius
Tertius's brothers|Tertius%27s_brothers
Leonie Tremblay|Leonie_Tremblay
Tristan|Tristan
Aristotle Twelvetrees|Aristotle_Twelvetrees
Ugga|Ugga
Unidentified Narragansett children|Unidentified_Narragansett_children
Unidentified Narragansett mother|Unidentified_Narragansett_mother
Unidentified young wizard|Unidentified_young_wizard
Nerida Vulchanova|Nerida_Vulchanova
Helmut Weiss|Helmut_Weiss
Bridget Wenlock's cousin|Bridget_Wenlock%27s_cousin
Samson Wiblin|Samson_Wiblin
Wilfred the Wistful|Wilfred_the_Wistful
Heliotrope Wilkins|Heliotrope_Wilkins
Witch and Wizard Couple|Witch_and_Wizard_Couple
Wyvern of Wye|Wyvern_of_Wye
Zaccaria Innocenti|Zaccaria_Innocenti
Girl Sorted in 1858|Girl_Sorted_in_1858
Bush|Bush
Christopher Flack|Christopher_Flack
Nicolas Grimmett|Nicolas_Grimmett
Robert Hawking|Robert_Hawking
Eric Murley|Eric_Murley
Damian Perriss|Damian_Perriss
Edmund Spiers|Edmund_Spiers
Jonathan Spratt|Jonathan_Spratt
Terry Strickland|Terry_Strickland
Alice|Alice
Mauricius|Mauricius
Unidentified Slytherin girl (II)|Unidentified_Slytherin_girl_(II)
Unidentified Slytherin girl (III)|Unidentified_Slytherin_girl_(III)
Emma Vane (witch)|Emma_Vane_(witch)
Herbert Chorley|Herbert_Chorley
Unidentified nine-year old|Unidentified_nine-year_old
Baruffio|Baruffio
Agnes|Agnes
St Mungo's Hospital for Magical Maladies and Injuries Known Patients|St_Mungo%27s_Hospital_for_Magical_Maladies_and_Injuries_Known_Patients
Anonymous author of Hairy Snout, Human Heart|Anonymous_author_of_Hairy_Snout,_Human_Heart
Forbidden Forest wolf pack|Forbidden_Forest_wolf_pack
Unidentified werewolf|Unidentified_werewolf
Wagga Wagga Werewolf|Wagga_Wagga_Werewolf
Bitten St Mungo's patient|Bitten_St_Mungo%27s_patient
Grubby-looking St Mungo's patient|Grubby-looking_St_Mungo%27s_patient
Unidentified St Mungo's patient|Unidentified_St_Mungo%27s_patient
Winged St Mungo's patient|Winged_St_Mungo%27s_patient
Tarquin McTavish's neighbour|Tarquin_McTavish%27s_neighbour
Roberts|Roberts
Roberts's wife|Roberts%27s_wife
1992 Gryffindor-Slytherin Quidditch match spectators|1992_Gryffindor-Slytherin_Quidditch_match_spectators
Ernestina Abutor|Ernestina_Abutor
Dennis Aldermaston's mother|Dennis_Aldermaston%27s_mother
Cyprien Alesi|Cyprien_Alesi
Badeea Ali's mother|Badeea_Ali%27s_mother
Alice Longbottom's midwife|Alice_Longbottom%27s_midwife
Alejandra Alonso|Alejandra_Alonso
Pamela Alton's mother|Pamela_Alton%27s_mother
Chandra Amble|Chandra_Amble
Rosemary Ames|Rosemary_Ames
Rosana Amorim|Rosana_Amorim
Danielle Amorinus|Danielle_Amorinus
Debbie Amy|Debbie_Amy
Artemis (goddess)|Artemis_(goddess)
Artemis (owl)|Artemis_(owl)
Jane Austen|Jane_Austen
Bathsheda Babbling|Bathsheda_Babbling
Gwendoline Babcocke's mother|Gwendoline_Babcocke%27s_mother
Patrick Bagby's mother|Patrick_Bagby%27s_mother
Kquewanda Bailey|Kquewanda_Bailey
Balbine Lestrange (II)|Balbine_Lestrange_(II)
Bandon Banshee|Bandon_Banshee
Modesty Barebone's biological mother|Modesty_Barebone%27s_biological_mother
Celia Barnett|Celia_Barnett
Baruffio's wife|Baruffio%27s_wife
Unidentified witch in Bath|Unidentified_witch_in_Bath
Hetty Bayliss|Hetty_Bayliss
Violetta Beauvais|Violetta_Beauvais
Katie Bell's mother|Katie_Bell%27s_mother
Belvina Burke's daughter|Belvina_Burke%27s_daughter
Amy Benson|Amy_Benson
Sophie Berger|Sophie_Berger
Cleste Bergne|C%C3%A9leste_Bergne
Bernadette|Bernadette
Bernadette Beauchene|Bernadette_Beauchene
Beryl|Beryl
Unidentified Big Bean Shack spokeswoman|Unidentified_Big_Bean_Shack_spokeswoman
Gilbert Bingley's wife|Gilbert_Bingley%27s_wife
Trevor Birch's mother|Trevor_Birch%27s_mother
Genevieve Bladt|Genevieve_Bladt
Susan Blancheflower|Susan_Blancheflower
Lara Blishen|Lara_Blishen
Beatrix Bloxam's aunt|Beatrix_Bloxam%27s_aunt
Jordanna Bodiment|Jordanna_Bodiment
Bogle-banshee|Bogle-banshee
Sylvian Boigny|Sylvian_Boigny
Seraphina Bones|Seraphina_Bones
Gladys Boothby|Gladys_Boothby
Borboleta|Borboleta
Boyle|Boyle
Betty Braithwaite|Betty_Braithwaite
Bridget (journalist)|Bridget_(journalist)
Lavender Brown's mother|Lavender_Brown%27s_mother
Mary Buchanan|Mary_Buchanan
Zygmunt Budge's great-grandmother|Zygmunt_Budge%27s_great-grandmother
Rosalind Bungs|Rosalind_Bungs
Betty Burgess|Betty_Burgess
Eunice Cabanart|Eunice_Cabanart
Abigail R. Cankus|Abigail_R._Cankus
Lima Carneiro|Lima_Carneiro
Mary Cattermole's mother|Mary_Cattermole%27s_mother
Cecilia|Cecilia
Cecily|Cecily
Charles Weasley's colleagues|Charles_Weasley%27s_colleagues
Anna Chiwawa|Anna_Chiwawa
Cho Chang's mother|Cho_Chang%27s_mother
Agatha Chubb|Agatha_Chubb
Georgia Clark-Day|Georgia_Clark-Day
Ben Copper's mother|Ben_Copper%27s_mother
Yvette Coquelot|Yvette_Coquelot
Ellen Cracknell|Ellen_Cracknell
Dirk Cresswell's wife|Dirk_Cresswell%27s_wife
Clutterbuck Crispe|Clutterbuck_Crispe
Doris Crockford|Doris_Crockford
Glinda Crook|Glinda_Crook
Caspar Crouch's daughters|Caspar_Crouch%27s_daughters
Crowd outside bakery in Surrey|Crowd_outside_bakery_in_Surrey
Magali Crowe|Magali_Crowe
Gerda Curd|Gerda_Curd
Danielle|Danielle
Daryle|Daryle
Mabel Dashalot|Mabel_Dashalot
Day maid at Leaky Cauldron|Day_maid_at_Leaky_Cauldron
Blossom Degrasse|Blossom_Degrasse
Julia Dehoff (Muggle)|Julia_Dehoff_(Muggle)
Julia Dehoff (witch)|Julia_Dehoff_(witch)
Delacour sisters' cousins|Delacour_sisters%27_cousins
Apolline Delacour|Apolline_Delacour
Apolline Delacour's mother|Apolline_Delacour%27s_mother
Alison Denbright|Alison_Denbright
Amorette Deneuve|Amorette_Deneuve
Cedric Diggory's mother|Cedric_Diggory%27s_mother
DJ Martha|DJ_Martha
Damara Dodderidge|Damara_Dodderidge
Mary Dorkins|Mary_Dorkins
Dot|Dot
Benedita Dourado|Benedita_Dourado
Ellie Dowson|Ellie_Dowson
Margot Droope|Margot_Droope
Durmstrang girl|Durmstrang_girl
Vernon Dursley's secretary|Vernon_Dursley%27s_secretary
Dudley Dursley's wife|Dudley_Dursley%27s_wife
Dursley siblings' mother|Dursley_siblings%27_mother
Dursleys' female neighbour|Dursleys%27_female_neighbour
Earl of Paunchley's forced servants|Earl_of_Paunchley%27s_forced_servants
Edgecombe|Edgecombe
Edith Abernathy|Edith_Abernathy
Unidentified female Eeylops Owl Emporium employee|Unidentified_female_Eeylops_Owl_Emporium_employee
Andre Egwu's grandmother|Andre_Egwu%27s_grandmother
Andre Egwu's sister|Andre_Egwu%27s_sister
Elena Eldritch|Elena_Eldritch
Eliana's parents|Eliana%27s_parents
Elicia|Elicia
Elveira Elkins|Elveira_Elkins
Elsie|Elsie
Mimi Erland|Mimi_Erland
Esposito|Esposito
Ethel|Ethel
Portrait of a female etiquette teacher|Portrait_of_a_female_etiquette_teacher
Unidentified plump little witch examiner|Unidentified_plump_little_witch_examiner
G. F.|G._F.
Lordana F.|Lordana_F.
Bella Farley|Bella_Farley
Madge Farley|Madge_Farley
Franziska Faust|Franziska_Faust
Sendelina de la Felino|Sendelina_de_la_Felino
Loretta Fieldwake (criminal)|Loretta_Fieldwake_(criminal)
Loretta Fieldwake (Ministry employee)|Loretta_Fieldwake_(Ministry_employee)
Arabella Figg's parents|Arabella_Figg%27s_parents
Fisher's daughter|Fisher%27s_daughter
Mopsy Fleabert|Mopsy_Fleabert
Ursula Flint|Ursula_Flint
Fenella Flowerday|Fenella_Flowerday
Virginia Flowers|Virginia_Flowers
Ambrosius Flume's wife|Ambrosius_Flume%27s_wife
Lydia Fry|Lydia_Fry
Cornelius Fudge's wife|Cornelius_Fudge%27s_wife
Morwena Ganderwort|Morwena_Ganderwort
George Weasley's dance partner|George_Weasley%27s_dance_partner
Ghost carollers|Ghost_carollers
Eleanor Sarah Gibbs|Eleanor_Sarah_Gibbs
Gibson|Gibson
Gilbert Bingley's secretary|Gilbert_Bingley%27s_secretary
Ginger (musician)|Ginger_(musician)
Girl who played Amata|Girl_who_played_Amata
Girl who played Asha|Girl_who_played_Asha
Olivia Gleaves|Olivia_Gleaves
Katrina von Glockenspieler|Katrina_von_Glockenspieler
Gloomy nuns|Gloomy_nuns
Glossy|Glossy
Arsenia Gonzales|Arsenia_Gonzales
Rosie Goodwin|Rosie_Goodwin
Gordon's parents|Gordon%27s_parents
Leonora Gore|Leonora_Gore
Goshawk sisters|Goshawk_sisters
Diadema Goshawk|Diadema_Goshawk
Miranda Goshawk's mother|Miranda_Goshawk%27s_mother
Romilda Goshawk|Romilda_Goshawk
Tangwystl Goshawk|Tangwystl_Goshawk
Gregory Goyle's mother|Gregory_Goyle%27s_mother
Hermione Granger's mother|Hermione_Granger%27s_mother
Glynnis Griffiths|Glynnis_Griffiths
Wilda Griffiths|Wilda_Griffiths
Stoyanka Grozda|Stoyanka_Grozda
Wilhelmina Grubbly-Plank|Wilhelmina_Grubbly-Plank
Elladora Guffy|Elladora_Guffy
Zamira Gulch|Zamira_Gulch
Lorre Gustafson|Lorre_Gustafson
Gwenog|Gwenog
Joyce Haddock|Joyce_Haddock
Hall's wife|Hall%27s_wife
Penny Haywood's mother|Penny_Haywood%27s_mother
Gimlet-eyed Hogwarts Headmistress|Gimlet-eyed_Hogwarts_Headmistress
Veronica Heap|Veronica_Heap
Hermione Granger's sister|Hermione_Granger%27s_sister
Susanna Hesleden's mother|Susanna_Hesleden%27s_mother
Eulalie Hicks|Eulalie_Hicks
Shanice Higgins|Shanice_Higgins
Anna Hill-Hall|Anna_Hill-Hall
Iola Hillicker|Iola_Hillicker
Tamsin Hillicker|Tamsin_Hillicker
Marcus Hitchin's mother|Marcus_Hitchin%27s_mother
Violetta Hobday|Violetta_Hobday
Hogwarts school mice|Hogwarts_school_mice
Honoria|Honoria
Zelda Hum|Zelda_Hum
Grizel Hurtz|Grizel_Hurtz
Kay Hurwitz|Kay_Hurwitz
Ice cream seller|Ice_cream_seller
Ismelda Murk's paternal grandmother|Ismelda_Murk%27s_paternal_grandmother
Jacob's mother|Jacob%27s_mother
Eugenia Jenkins|Eugenia_Jenkins
Jackie Jernigan|Jackie_Jernigan
Hestia Jones|Hestia_Jones
Bertha Jorkins's aunt|Bertha_Jorkins%27s_aunt
Primrose Jorkins|Primrose_Jorkins
Josephine Kay|Josephine_Kay
Jude Ho|Jude_Ho
Tulip Karasu's mother|Tulip_Karasu%27s_mother
Lucy Karoonda|Lucy_Karoonda
Gertie Keddle|Gertie_Keddle
Josette Kelius|Josette_Kelius
Hilda Kendrick|Hilda_Kendrick
Silvanus Kettleburn's mother|Silvanus_Kettleburn%27s_mother
Kevin's mother|Kevin%27s_mother
Rowan Khanna's mother|Rowan_Khanna%27s_mother
Katie Killick|Katie_Killick
Irene Kneedander|Irene_Kneedander
Gunhilda Kneen|Gunhilda_Kneen
H. Knighton's wife|H._Knighton%27s_wife
Aged witch|Aged_witch
Jacob Kowalski's grandmother|Jacob_Kowalski%27s_grandmother
Sigrid Kristoffersen|Sigrid_Kristoffersen
Viktor Krum's mother|Viktor_Krum%27s_mother
Viola Landers|Viola_Landers
Landlady of the Green Dragon|Landlady_of_the_Green_Dragon
Diane Launier|Diane_Launier
Laura|Laura
Laura Thorn's sister|Laura_Thorn%27s_sister
Lauren|Lauren
Leaky Cauldron bartender|Leaky_Cauldron_bartender
Barnaby Lee's grandmother|Barnaby_Lee%27s_grandmother
Leesk|Leesk
Balbine Lestrange (I)|Balbine_Lestrange_(I)
Darenne Lestrange|Darenne_Lestrange
Jodelle Lestrange|Jodelle_Lestrange
Luminosa Lestrange|Luminosa_Lestrange
Noza Lestrange|Noz%C3%A9a_Lestrange
Pucine Lestrange (II)|Pucine_Lestrange_(II)
Pucine Lestrange (I)|Pucine_Lestrange_(I)
Quintilla Lestrange|Quintilla_Lestrange
Sotre Lestrange|Sot%C3%A8re_Lestrange
Mina Lima|Mina_Lima
Chiara Lobosca's mother|Chiara_Lobosca%27s_mother
Harfang Longbottom's daughter|Harfang_Longbottom%27s_daughter
Enid Longbottom|Enid_Longbottom
Mattie Lovett|Mattie_Lovett
Loxias's mother|Loxias%27s_mother
Mafalda's mother|Mafalda%27s_mother
Magee|Magee
Magical Menagerie saleswoman|Magical_Menagerie_saleswoman
Joan Maguire Cook|Joan_Maguire_Cook
Malkin|Malkin
Marjorie Dursley's unknown eleven bulldogs|Marjorie_Dursley%27s_unknown_eleven_bulldogs
Marlow|Marlow
Marsh|Marsh
Martha (American Muggle)|Martha_(American_Muggle)
Martha (British Muggle)|Martha_(British_Muggle)
Mason's wife|Mason%27s_wife
Emily Mather|Emily_Mather
Gabriella Mather|Gabriella_Mather
Daphne Mauboisan|Daphne_Mauboisan
Ella Max|Ella_Max
Olympe Maxime's mother|Olympe_Maxime%27s_mother
Meaghan McCormack|Meaghan_McCormack
Robert McGonagall Senior's mother|Robert_McGonagall_Senior%27s_mother
Stephenie McMillan|Stephenie_McMillan
Katura Melkor|Katura_Melkor
Melusine|Melusine
Eduaphora Mergus|Eduaphora_Mergus
Galatea Merrythought|Galatea_Merrythought
Merula Snyde's aunt|Merula_Snyde%27s_aunt
Michael's escort at King's Cross Station|Michael%27s_escort_at_King%27s_Cross_Station
Milly|Milly
Minerva|Minerva
Miraforum (British witch)|Miraforum_(British_witch)
Miraphorus|Miraphorus
Lilith Molesby|Lilith_Molesby
Tilly Monk|Tilly_Monk
Maud Montagu|Maud_Montagu
Graham Montague's mother|Graham_Montague%27s_mother
Maud Montague|Maud_Montague
Montgomery children's mother|Montgomery_children%27s_mother
Alastor Moody's mother|Alastor_Moody%27s_mother
Moran|Moran
Gwendolyn Morgan|Gwendolyn_Morgan
Valmai Morgan|Valmai_Morgan
Mother of boy who owned a magic hamster|Mother_of_boy_who_owned_a_magic_hamster
Muggle at Millennium Bridge|Muggle_at_Millennium_Bridge
Muggle residents of Budleigh Babberton|Muggle_residents_of_Budleigh_Babberton
Unidentified Muggle woman|Unidentified_Muggle_woman
Unidentified Muggle woman (II)|Unidentified_Muggle_woman_(II)
Staring Muggle|Staring_Muggle
Mullet|Mullet
Muriel's mother|Muriel%27s_mother
Ismelda Murk's mother|Ismelda_Murk%27s_mother
Murphy McNully's grandmother|Murphy_McNully%27s_grandmother
Murphy McNully's mother|Murphy_McNully%27s_mother
Naasz|Naasz
Ignis Nagy|Ignis_Nagy
Natalya|Natalya
Z. Nettles|Z._Nettles
Nigel's wife|Nigel%27s_wife
Nigelle le Narcissique|Nigelle_le_Narcissique
Night maid at the Leaky Cauldron|Night_maid_at_the_Leaky_Cauldron
Mercy Ojukwu|Mercy_Ojukwu
Aliko Okoye|Aliko_Okoye
Anji Oliver|Anji_Oliver
Garrick Ollivander's daughter|Garrick_Ollivander%27s_daughter
Garrick Ollivander's mother|Garrick_Ollivander%27s_mother
Garrick Ollivander's wife|Garrick_Ollivander%27s_wife
1996 Gryffindor Quidditch Keeper trials spectators|1996_Gryffindor_Quidditch_Keeper_trials_spectators
Albus Potter's ferret|Albus_Potter%27s_ferret
Albus Potter's owl|Albus_Potter%27s_owl
R. Amorim (American)|R._Amorim_(American)
R. Amorim (British)|R._Amorim_(British)
N. Amorinus|N._Amorinus
Amycus Carrow's successor|Amycus_Carrow%27s_successor
Aravind C.|Aravind_C.
Astoria Malfoy's ancestor|Astoria_Malfoy%27s_ancestor
Bagshot|Bagshot
Band at William Weasley and Fleur Delacour's wedding|Band_at_William_Weasley_and_Fleur_Delacour%27s_wedding
Bell|Bell
Bletchley|Bletchley
Blishen (Muggle)|Blishen_(Muggle)
J. Blishen|J._Blishen
Y. Blishen|Y._Blishen
Beatrix Bloxam's cousins|Beatrix_Bloxam%27s_cousins
Bungy|Bungy
Cadium Featherstone|Cadium_Featherstone
Cadogan's pony|Cadogan%27s_pony
M. Carneiro (Muggle)|M._Carneiro_(Muggle)
M. Carneirus (American)|M._Carneirus_(American)
M. P. Carneirus|M._P._Carneirus
Cho Chang's spouse|Cho_Chang%27s_spouse
Cliodna's birds|Cliodna%27s_birds
Cogg|Cogg
Cook at the Leaky Cauldron|Cook_at_the_Leaky_Cauldron
Cooper children|Cooper_children
Dirk Cresswell's friends|Dirk_Cresswell%27s_friends
Crispin Cronk's sphinxes|Crispin_Cronk%27s_sphinxes
Cyprian Youdle's killer|Cyprian_Youdle%27s_killer
Director of the Investigation Department No. 61042|Director_of_the_Investigation_Department_No._61042
Director of the Ministry Police No. 41041|Director_of_the_Ministry_Police_No._41041
Draco Malfoy's eagle owl|Draco_Malfoy%27s_eagle_owl
Dudley Dursley's parrot|Dudley_Dursley%27s_parrot
Dudley Dursley's tortoise|Dudley_Dursley%27s_tortoise
Editor of Which Broomstick?|Editor_of_Which_Broomstick?
Ellerby|Ellerby
Employee of the Hogsmeade Post Office|Employee_of_the_Hogsmeade_Post_Office
FDM|FDM
D. Figueiredus|D._Figueiredus
E. L. Filhus|E._L._Filhus
Fleetwing|Fleetwing
Fleetwood|Fleetwood
Filius Flitwick's goblin ancestor|Filius_Flitwick%27s_goblin_ancestor
G. Forbes|G._Forbes
Foreign President|Foreign_President
Gamp|Gamp
Kit Gerrard|Kit_Gerrard
Ghoul in Grimmauld Place|Ghoul_in_Grimmauld_Place
Gilderoy Lockhart's neighbour|Gilderoy_Lockhart%27s_neighbour
Gormless Morgan's friends|Gormless_Morgan%27s_friends
Grangers' dogs|Grangers%27_dogs
Gringott's Dragon|Gringott%27s_Dragon
Grisema Quoia|Grisema_Quoia
Hawk-like owl|Hawk-like_owl
Herpo the Foul's basilisk|Herpo_the_Foul%27s_basilisk
Hogwarts Express driver|Hogwarts_Express_driver
Hogwarts Giant Squid|Hogwarts_Giant_Squid
Hoppy|Hoppy
Horace Slughorn's owl|Horace_Slughorn%27s_owl
Hothoof|Hothoof
Infant Demonic|Infant_Demonic
James Potter II's owl|James_Potter_II%27s_owl
Jenna Jovius|Jenna_Jovius
Bertha Jorkins's second cousin|Bertha_Jorkins%27s_second_cousin
Khanna family house-elf|Khanna_family_house-elf
Kneil|Kneil
H. Knighton's offspring|H._Knighton%27s_offspring
H . O. Lama|H_._O._Lama
E. Lambini|E._Lambini
Laurenzoo|Laurenzoo
E. Limus|E._Limus
E. A. Limus|E._A._Limus
W. Lozzus|W._Lozzus
Lucius Malfoy's dogs|Lucius_Malfoy%27s_dogs
M. Carneiro (wizard)|M._Carneiro_(wizard)
K. Machadus|K._Machadus
Mafalda Hopkirk's Ministerial Superior|Mafalda_Hopkirk%27s_Ministerial_Superior
Matey|Matey
Evaan Mathew|Evaan_Mathew
Mauler|Mauler
Mayer|Mayer
McGonagalls' cat|McGonagalls%27_cat
McHavelock|McHavelock
Medusa|Medusa
Millicent Bulstrode's cat|Millicent_Bulstrode%27s_cat
M. Mina|M._Mina
Minerva McGonagall's successor|Minerva_McGonagall%27s_successor
Ministry of Magic Visitor No. 09602|Ministry_of_Magic_Visitor_No._09602
Ministry of Magic Visitor No. 09603|Ministry_of_Magic_Visitor_No._09603
Ministry of Magic Visitor No. 09786|Ministry_of_Magic_Visitor_No._09786
Ministry Official No. 39423|Ministry_Official_No._39423
M. L. Minus|M._L._Minus
M. L. Miraphorum|M._L._Miraphorum
M. Miraphorumus|M._Miraphorumus
Miromy Hara|Miromy_Hara
Modesty Rabnott's hippogriff|Modesty_Rabnott%27s_hippogriff
Monstrous Leaky Cauldron guest|Monstrous_Leaky_Cauldron_guest
Morfin Gaunt's first snake|Morfin_Gaunt%27s_first_snake
Morfin Gaunt's second snake|Morfin_Gaunt%27s_second_snake
Moribund|Moribund
Name|Name
Name author|Name_author
M. P. Nettum|M._P._Nettum
Nevin|Nevin
N. Newzer|N._Newzer
Nigel Wolpert's owl|Nigel_Wolpert%27s_owl
L. O'Sullivan|L._O%27Sullivan
Overweight Ministry of Magic worker|Overweight_Ministry_of_Magic_worker
Painting of a caged monkey|Painting_of_a_caged_monkey
Painting of a giraffe|Painting_of_a_giraffe
Painting of a hippopotamus|Painting_of_a_hippopotamus
Painting of a tiger|Painting_of_a_tiger
Painting of a wolfhound|Painting_of_a_wolfhound
Painting of an elephant|Painting_of_an_elephant
R. Palombus|R._Palombus
Riya Patel|Riya_Patel
J. Pippin|J._Pippin
H. Pollingtonious|H._Pollingtonious
Port Authority boss|Port_Authority_boss
Portrait of a dog|Portrait_of_a_dog
Portrait of a mother and baby|Portrait_of_a_mother_and_baby
Portrait of people watching Quidditch|Portrait_of_people_watching_Quidditch
Prime Minister's political opponent|Prime_Minister%27s_political_opponent
Proudfoot|Proudfoot
Quentin Sparkle|Quentin_Sparkle
R's messengers|R%27s_messengers
M. Ralphous|M._Ralphous
Robert McGonagall Senior's friends|Robert_McGonagall_Senior%27s_friends
Rodney Rohesia|Rodney_Rohesia
Ronald Weasley's frog|Ronald_Weasley%27s_frog
Rosalind Ness|Rosalind_Ness
Rosmerta's cat|Rosmerta%27s_cat
Rosmerta's dog|Rosmerta%27s_dog
Sam's owner|Sam%27s_owner
Savage|Savage
Scrivenshaft|Scrivenshaft
Erika Ostensen|Erika_Ostensen
Owner of 7 Privet Drive|Owner_of_7_Privet_Drive
Owner of the Railview Hotel|Owner_of_the_Railview_Hotel
Daniel Page's sister|Daniel_Page%27s_sister
Paper shop girl|Paper_shop_girl
Lenelle Paraison|Lenelle_Paraison
Patil twins' mother|Patil_twins%27_mother
Patricia Rakepick's mother|Patricia_Rakepick%27s_mother
Huguette Perrot|Huguette_Perrot
Laurelle Perrot|Laurelle_Perrot
Odile Perrot|Odile_Perrot
Amanda Pettet|Amanda_Pettet
Enid Pettigrew|Enid_Pettigrew
Phoebe Clem|Phoebe_Clem
Constance Pickering's mother|Constance_Pickering%27s_mother
Pidgron sisters|Pidgron_sisters
Irma Pince|Irma_Pince
E. Pinecoffin|E._Pinecoffin
Arlene Piper|Arlene_Piper
Iris Pius|Iris_Pius
Mirabella Plunkett's mother|Mirabella_Plunkett%27s_mother
Piers Polkiss's mother|Piers_Polkiss%27s_mother
Poppy|Poppy
Petrova Porskoff|Petrova_Porskoff
Portrait of a family|Portrait_of_a_family
Portrait of a group of journeying wizards|Portrait_of_a_group_of_journeying_wizards
Portrait of a group of women in crinolines|Portrait_of_a_group_of_women_in_crinolines
Portrait of a mermaid|Portrait_of_a_mermaid
Portrait of a witch flying to the moon|Portrait_of_a_witch_flying_to_the_moon
Portrait of a witch in a meadow|Portrait_of_a_witch_in_a_meadow
Portrait of a witch in green|Portrait_of_a_witch_in_green
Portrait of a witch in Pompadour hairstyle|Portrait_of_a_witch_in_Pompadour_hairstyle
Portrait of three young ladies|Portrait_of_three_young_ladies
Portrait of two lovers in a graveyard|Portrait_of_two_lovers_in_a_graveyard
Portrait of wailing women|Portrait_of_wailing_women
Molly Weasley's mother|Molly_Weasley%27s_mother
Primpernelle|Primpernelle
Jodie Pritchard|Jodie_Pritchard
Elsie Prod|Elsie_Prod
Puddifoot|Puddifoot
Quintia Qarase|Quintia_Qarase
Symposia Rawle|Symposia_Rawle
Unidentified red-haired witch|Unidentified_red-haired_witch
Unidentified female reporter|Unidentified_female_reporter
Riddles' cook|Riddles%27_cook
Riddles' maid|Riddles%27_maid
C. Roemmele|C._Roemmele
Alexandra Rokonski|Alexandra_Rokonski
Isodora Rose|Isodora_Rose
Rosie|Rosie
Minette Lestrange|Minette_Lestrange
Isobel Ross's mother|Isobel_Ross%27s_mother
Euphemia Rowle|Euphemia_Rowle
Regina Rowle|Regina_Rowle
Rowena Rowle|Rowena_Rowle
Ruby (witch)|Ruby_(witch)
Nellie Lo Russell|Nellie_Lo_Russell
Elicia Scales|Elicia_Scales
Newton Scamander's mother|Newton_Scamander%27s_mother
Lisbeth Scintilla|Lisbeth_Scintilla
Selina|Selina
Sharon|Sharon
Kitty Sharp|Kitty_Sharp
Scarlet Sharp|Scarlet_Sharp
Ruby Sheldon|Ruby_Sheldon
Shepherdess|Shepherdess
Maisie Sheppard|Maisie_Sheppard
Dorothy Sheridan|Dorothy_Sheridan
Lara Sigg|Lara_Sigg
Lara Von Sigg|Lara_Von_Sigg
Silvia|Silvia
Narinder Singh|Narinder_Singh
Ariel Singleton|Ariel_Singleton
Aurora Sinistra|Aurora_Sinistra
Enid Smeek|Enid_Smeek
Smeltings nurse|Smeltings_nurse
Lisa Smith|Lisa_Smith
Smoky-eyed Potions professor|Smoky-eyed_Potions_professor
Georgina Smyth|Georgina_Smyth
Sofie|Sofie
Sophie Duchamps|Sophie_Duchamps
Emma Squiggle|Emma_Squiggle
Theresa Stadt|Theresa_Stadt
Violeta Stitch|Violeta_Stitch
Brunhilde Stokke|Brunhilde_Stokke
Miriam Strout|Miriam_Strout
Sunita Mistry|Sunita_Mistry
Sylvia|Sylvia
Keiko Takahashi|Keiko_Takahashi
Tessie|Tessie
The Fates|The_Fates
Janus Thickey's wife|Janus_Thickey%27s_wife
Dean Thomas's mother|Dean_Thomas%27s_mother
Lucinda Thomsonicle-Pocus|Lucinda_Thomsonicle-Pocus
Violet Tillyman|Violet_Tillyman
Violet Tillyman's mother|Violet_Tillyman%27s_mother
Agatha Timms|Agatha_Timms
Alice Tolipan (Muggle)|Alice_Tolipan_(Muggle)
Sybill Trelawney's mother|Sybill_Trelawney%27s_mother
Donaghan Tremlett's wife|Donaghan_Tremlett%27s_wife
Donaghan Tremlett's mother|Donaghan_Tremlett%27s_mother
Bronwyn Trigg|Bronwyn_Trigg
Magenta Tripe|Magenta_Tripe
Tubbs|Tubbs
Felicitania Tugwood|Felicitania_Tugwood
Alanza Alves's grandmother|Alanza_Alves%27s_grandmother
Liz Tuttle's maternal grandmother|Liz_Tuttle%27s_maternal_grandmother
Daisy Twemlove|Daisy_Twemlove
Wilhemina Twigge|Wilhemina_Twigge
Unidentified 19th-century Herbology professor|Unidentified_19th-century_Herbology_professor
Unidentified Beauxbatons students|Unidentified_Beauxbatons_students
Unidentified Daily Prophet journalist|Unidentified_Daily_Prophet_journalist
Unidentified Dark Witch|Unidentified_Dark_Witch
Unidentified daughter|Unidentified_daughter
Unidentified executioner (I)|Unidentified_executioner_(I)
Unidentified female Council of Magical Law juror|Unidentified_female_Council_of_Magical_Law_juror
Unidentified female Customer in Bakery|Unidentified_female_Customer_in_Bakery
Unidentified female Swedish Shortsnout|Unidentified_female_Swedish_Shortsnout
Unidentified florist in Diagon Alley|Unidentified_florist_in_Diagon_Alley
Unidentified French Ministry of Magic receptionist|Unidentified_French_Ministry_of_Magic_receptionist
Unidentified frizzy-haired Wizengamot member|Unidentified_frizzy-haired_Wizengamot_member
Unidentified Ghosts|Unidentified_Ghosts
Unidentified grandmother|Unidentified_grandmother
Unidentified guide|Unidentified_guide
Unidentified Hogwarts employees|Unidentified_Hogwarts_employees
Unidentified housewife|Unidentified_housewife
Unidentified MACUSA Aurors|Unidentified_MACUSA_Aurors
Unidentified Madam Malkin's Robes for All Occasions employee|Unidentified_Madam_Malkin%27s_Robes_for_All_Occasions_employee
Unidentified Ministry witch (I)|Unidentified_Ministry_witch_(I)
Unidentified Muggle child in Zoo|Unidentified_Muggle_child_in_Zoo
Unidentified Muggle girl from Liverpool|Unidentified_Muggle_girl_from_Liverpool
Unidentified Muggle woman (III)|Unidentified_Muggle_woman_(III)
Unidentified Muggle woman about the train to Kettering|Unidentified_Muggle_woman_about_the_train_to_Kettering
Unidentified Muggle woman on Chertsey train|Unidentified_Muggle_woman_on_Chertsey_train
Unidentified Muggle woman who was looking at Rubeus Hagrid in 1991|Unidentified_Muggle_woman_who_was_looking_at_Rubeus_Hagrid_in_1991
Unidentified nine-year old's grandparents|Unidentified_nine-year_old%27s_grandparents
Unidentified Ollivander's assistant|Unidentified_Ollivander%27s_assistant
Unidentified pamphlet maker witch|Unidentified_pamphlet_maker_witch
Unidentified portrait in Malfoy Manor (I)|Unidentified_portrait_in_Malfoy_Manor_(I)
Unidentified Sleeping Headmistress with Rings|Unidentified_Sleeping_Headmistress_with_Rings
Unidentified Sleeping Headmistress with Sphere|Unidentified_Sleeping_Headmistress_with_Sphere
Unidentified soap actress|Unidentified_soap_actress
Unidentified studying girls|Unidentified_studying_girls
Unidentified teacher at St. Grogory's Primary School|Unidentified_teacher_at_St._Grogory%27s_Primary_School
Unidentified Thestrals|Unidentified_Thestrals
Unidentified two elderly Wizengamot witches|Unidentified_two_elderly_Wizengamot_witches
Unidentified young wife|Unidentified_young_wife
Elsie Valentine Schroeder|Elsie_Valentine_Schroeder
Valerie Valion|Valerie_Valion
Louise Van Hawe|Louise_Van_Hawe
Emma Vane (Muggle)|Emma_Vane_(Muggle)
Emma Vane's mother|Emma_Vane%27s_mother
Romilda Vane's grandmother|Romilda_Vane%27s_grandmother
Nikola Vassileva|Nikola_Vassileva
Septima Vector|Septima_Vector
Verity|Verity
Veronica Vexmoor|Veronica_Vexmoor
Vibes Twins|Vibes_Twins
Violet|Violet
Voice of lift at the Ministry of Magic|Voice_of_lift_at_the_Ministry_of_Magic
Valentina Vzquez|Valentina_V%C3%A1zquez
Wailing Widow|Wailing_Widow
Waitress at Luchino Caffe|Waitress_at_Luchino_Caffe
Wakanda|Wakanda
Lauren Wakefield (in-universe)|Lauren_Wakefield_(in-universe)
Wandless|Wandless
Celestina Warbeck's mother|Celestina_Warbeck%27s_mother
Mercy Wardwell|Mercy_Wardwell
Myrtle Warren's mother|Myrtle_Warren%27s_mother
Warrington sisters' grandmother|Warrington_sisters%27_grandmother
Winifred Warrington|Winifred_Warrington
Weasley family chickens|Weasley_family_chickens
Audrey Weasley|Audrey_Weasley
Roxanne Weasley|Roxanne_Weasley
Nicola Wells|Nicola_Wells
Saranna Wilkinson|Saranna_Wilkinson
Heliotrope Willis|Heliotrope_Willis
Winky's grandmother|Winky%27s_grandmother
Winky's mother|Winky%27s_mother
Jennifer Winston|Jennifer_Winston
Unidentified witch who tried to make an Aprils Fool on Alastor Moody at Aprils Fools Day|Unidentified_witch_who_tried_to_make_an_Aprils_Fool_on_Alastor_Moody_at_Aprils_Fools_Day
Witch with a hairy chin|Witch_with_a_hairy_chin
Dawn Withey|Dawn_Withey
Portrait of a female nurse in the hospital wing|Portrait_of_a_female_nurse_in_the_hospital_wing
Woman at Wedding of Bill and Fleur|Woman_at_Wedding_of_Bill_and_Fleur
Oliver Wood's mother|Oliver_Wood%27s_mother
Wool woman|Wool_woman
Young witch maid|Young_witch_maid
Yvonne|Yvonne
Blaise Zabini's mother|Blaise_Zabini%27s_mother
Ya Zhou|Ya_Zhou
Zygmunt Budge's sheep|Zygmunt_Budge%27s_sheep
2-Headed Baby|2-Headed_Baby
Theophilus Abbot|Theophilus_Abbot
Achilles Tolliver|Achilles_Tolliver
Enoch Acidus|Enoch_Acidus
Actor who played Crapaud|Actor_who_played_Crapaud
Actor who played Grenouille|Actor_who_played_Grenouille
Jomauh Agardh|Jomauh_Agardh
Agnes's son|Agnes%27s_son
Babajide Akingbade|Babajide_Akingbade
Albino peacock|Albino_peacock
Albus Dumbledore's great-great-grandfather|Albus_Dumbledore%27s_great-great-grandfather
Arkie Alderton|Arkie_Alderton
William Alderton|William_Alderton
Raul Almeida|Raul_Almeida
Pedrus Almeidus|Pedrus_Almeidus
M. Amerinus|M._Amerinus
Amos Hopkins|Amos_Hopkins
Anderson|Anderson
Announcer at Henry Shaw Junior's fundraising dinner|Announcer_at_Henry_Shaw_Junior%27s_fundraising_dinner
Jonny Anomaly|Jonny_Anomaly
Antonio|Antonio
Apothecary shopkeeper|Apothecary_shopkeeper
Walter Aragon|Walter_Aragon
Armenian warlock|Armenian_warlock
Arnold|Arnold
Arthur Weasley's contact at the Floo Regulation Panel|Arthur_Weasley%27s_contact_at_the_Floo_Regulation_Panel
Unidentified Aurors stationed at the Great Hall|Unidentified_Aurors_stationed_at_the_Great_Hall
Edwin Avarus|Edwin_Avarus
Aviemore station master|Aviemore_station_master
Archie Aymslowe|Archie_Aymslowe
Badgered Boy|Badgered_Boy
Ludovic Bagman's father|Ludovic_Bagman%27s_father
Otto Bagman|Otto_Bagman
Fred Baille|Fred_Baille
Alistair Ballcocke|Alistair_Ballcocke
Alistaire Ballcocke|Alistaire_Ballcocke
Jos Barboza|Jos%C3%A9_Barboza
Modesty Barebone's biological father|Modesty_Barebone%27s_biological_father
Lucas Bargeworthy|Lucas_Bargeworthy
Barker (Muggle)|Barker_(Muggle)
Barman at the Three Broomsticks|Barman_at_the_Three_Broomsticks
Michael Barnathan|Michael_Barnathan
Elsie Barrett|Elsie_Barrett
J. M. Barrie|J._M._Barrie
Ali Bashir|Ali_Bashir
Basil|Basil
Basil Silva|Basil_Silva
John Bastedo|John_Bastedo
Podric Batworthy XXIII|Podric_Batworthy_XXIII
Charlie Baverstock|Charlie_Baverstock
Herbert Beery|Herbert_Beery
Marcus Belby's father|Marcus_Belby%27s_father
Eugene Belcher|Eugene_Belcher
Humphrey Belcher|Humphrey_Belcher
Katie Bell's father|Katie_Bell%27s_father
Benedict|Benedict
Angelo Benitez|Angelo_Benitez
Benjamin Hater|Benjamin_Hater
Bennett Burgess|Bennett_Burgess
Archibald Bennett|Archibald_Bennett
Bernie|Bernie
Mordecai Berrycloth|Mordecai_Berrycloth
Norville Bezerko|Norville_Bezerko
Archibald Bienbon|Archibald_Bienbon
William Billings|William_Billings
Bimp|Bimp
Gilbert Bingley|Gilbert_Bingley
Cuthbert Binns's father|Cuthbert_Binns%27s_father
Brevis Birch|Brevis_Birch
Dennis Bishop|Dennis_Bishop
Black Knight|Black_Knight
Sirius Black I|Sirius_Black_I
Yuri Von Blisch|Yuri_Von_Blisch
Yuri Blischen|Yuri_Blischen
David Blishen|David_Blishen
Yuri Blishen|Yuri_Blishen
Yuri Blishenov|Yuri_Blishenov
Jimbo Blishwick|Jimbo_Blishwick
Robert Bliss|Robert_Bliss
Bloke who fixed the toilet at Leaky Cauldron|Bloke_who_fixed_the_toilet_at_Leaky_Cauldron
Jean-Baptiste Bloncourt|Jean-Baptiste_Bloncourt
Raymond Bloom|Raymond_Bloom
Blordak|Blordak
Peter Blotting|Peter_Blotting
Beatrix Bloxam's father|Beatrix_Bloxam%27s_father
Stubby Boardman|Stubby_Boardman
Bob|Bob
Edmund Bollifant|Edmund_Bollifant
Hector Bolobolo|Hector_Bolobolo
Boniface|Boniface
Libatius Borage|Libatius_Borage
Boris the Bewildered|Boris_the_Bewildered
Borys the Brute|Borys_the_Brute
Phineas Bourne|Phineas_Bourne
Sanderson Bowles|Sanderson_Bowles
Boy who kept a bezoar in his pocket's brother|Boy_who_kept_a_bezoar_in_his_pocket%27s_brother
Bozo|Bozo
Rudolf Brand|Rudolf_Brand
Maximus Brankovitch III|Maximus_Brankovitch_III
Brian|Brian
British Prime Minister in 1996|British_Prime_Minister_in_1996
Karl Broadmoor|Karl_Broadmoor
Kevin Broadmoor|Kevin_Broadmoor
Rupert Brookstanton|Rupert_Brookstanton
Gordon Brown|Gordon_Brown
Lavender Brown's father|Lavender_Brown%27s_father
Bruno Bruunhart|Bruno_Bruunhart
John Buchanan|John_Buchanan
Budleigh Babberton milkman|Budleigh_Babberton_milkman
Burgock|Burgock
Belvina Burke's sons|Belvina_Burke%27s_sons
Caractacus Burke|Caractacus_Burke
Herbert Burke|Herbert_Burke
George W. Bush|George_W._Bush
Cadogan's portraitist|Cadogan%27s_portraitist
Caesar|Caesar
Calvert Tillery|Calvert_Tillery
Angus Campbell|Angus_Campbell
Lennox Campbell|Lennox_Campbell
Sol Campbell|Sol_Campbell
Diego Caplan's grandfather|Diego_Caplan%27s_grandfather
Caractacus|Caractacus
Haniball Carathi|Haniball_Carathi
Mauricio Carneiro|Mauricio_Carneiro
Oliver Cartwright|Oliver_Cartwright
Luca Caruso (Muggle)|Luca_Caruso_(Muggle)
Luccas Carusus|Luccas_Carusus
Caspar Crouch's son|Caspar_Crouch%27s_son
Mary Cattermole's father|Mary_Cattermole%27s_father
Arturo Cephalopos|Arturo_Cephalopos
Ceremony official|Ceremony_official
Mauricius Carneirus|Mauricius_Carneirus
Cho Chang's father|Cho_Chang%27s_father
Chas|Chas
Chief Warlock of the Wizengamot in 1544|Chief_Warlock_of_the_Wizengamot_in_1544
Terry Chloe|Terry_Chloe
Chrisp|Chrisp
Circus Arcanus house-elf|Circus_Arcanus_house-elf
Clarke|Clarke
Jeremy Clarkson|Jeremy_Clarkson
Cleaner at Leaky Cauldron|Cleaner_at_Leaky_Cauldron
Nick Clegg|Nick_Clegg
Bill Clinton|Bill_Clinton
Carlos Clodoaldo|Carlos_Clodoaldo
Horatio Cloke|Horatio_Cloke
Joo Coelho|Jo%C3%A3o_Coelho
Unidentified Committee for the Disposal of Dangerous Creatures member|Unidentified_Committee_for_the_Disposal_of_Dangerous_Creatures_member
Connolly|Connolly
John Constable|John_Constable
Mark Constantine|Mark_Constantine
Cook of The Hanged Man|Cook_of_The_Hanged_Man
Buckley Cooper's brother|Buckley_Cooper%27s_brother
Buckley Cooper|Buckley_Cooper
Howland Coopey|Howland_Coopey
Ben Copper's father|Ben_Copper%27s_father
Gregory Cotton|Gregory_Cotton
Council of Magical Law guards|Council_of_Magical_Law_guards
George Coutas|George_Coutas
Stuart Craggius|Stuart_Craggius
Creevey brothers' father|Creevey_brothers%27_father
Cresswell brothers|Cresswell_brothers
Saul Croaker|Saul_Croaker
Bartemius Crouch Snr's grandfather|Bartemius_Crouch_Snr%27s_grandfather
Hector Dagworth-Granger|Hector_Dagworth-Granger
Alistair Darling|Alistair_Darling
Vincent Davies|Vincent_Davies
Vincent Davis|Vincent_Davis
Caradoc Dearborn|Caradoc_Dearborn
Decorative waiter serving Dragon Tartare|Decorative_waiter_serving_Dragon_Tartare
Daniel Defoe|Daniel_Defoe
Julius Dehoff|Julius_Dehoff
Julius Dehoffe|Julius_Dehoffe
Delacour sisters' father|Delacour_sisters%27_father
Jason Denbright|Jason_Denbright
Simon Dentata|Simon_Dentata
Unidentified Department of Mysteries intern|Unidentified_Department_of_Mysteries_intern
Philbert Deverill|Philbert_Deverill
Fernando Diaz|Fernando_Diaz
Dedalus Diggle|Dedalus_Diggle
Amos Diggory|Amos_Diggory
Ivor Dillonsby|Ivor_Dillonsby
Dirk|Dirk
Dishevelled Wizard|Dishevelled_Wizard
Ragmar Dorkins|Ragmar_Dorkins
Double-ended-newt wizard|Double-ended-newt_wizard
Rob Dowson|Rob_Dowson
Dimitar Draganov|Dimitar_Draganov
Dragon keeper|Dragon_keeper
Dre Head|Dre_Head
Driving test examiner|Driving_test_examiner
Dudley|Dudley
Davet Dumont|Davet_Dumont
Heinrich Eberstadt|Heinrich_Eberstadt
Perseus Ecklington|Perseus_Ecklington
Edgar|Edgar
Marietta Edgecombe's father|Marietta_Edgecombe%27s_father
Eduardo|Eduardo
Carlos Eduardos|Carlos_Eduardos
Cecil Edwards|Cecil_Edwards
Charles Edwards|Charles_Edwards
Joseph Edwards|Joseph_Edwards
Mordicus Egg|Mordicus_Egg
Unidentified male Egyptian in the Weasleys' photograph|Unidentified_male_Egyptian_in_the_Weasleys%27_photograph
Unidentified male Egyptian in the Weasleys' photograph (II)|Unidentified_male_Egyptian_in_the_Weasleys%27_photograph_(II)
Unidentified male Egyptian in the Weasleys' photograph (III)|Unidentified_male_Egyptian_in_the_Weasleys%27_photograph_(III)
Elderly visitor at Leaky Cauldron|Elderly_visitor_at_Leaky_Cauldron
Elderly wizard in an emerald-green cloak|Elderly_wizard_in_an_emerald-green_cloak
Stanley Eldridge|Stanley_Eldridge
Elite No-Maj|Elite_No-Maj
Samuel Equiano|Samuel_Equiano
Jacob Erland|Jacob_Erland
Errol|Errol
Unidentified examiner with a wart on his nose|Unidentified_examiner_with_a_wart_on_his_nose
G. F.'s grandfather|G._F.%27s_grandfather
Faris Spavin's centaur assailant|Faris_Spavin%27s_centaur_assailant
Charlie Farley|Charlie_Farley
Jake Farley|Jake_Farley
Fat ghost in stairwell|Fat_ghost_in_stairwell
Father of boy who owned a magic hamster|Father_of_boy_who_owned_a_magic_hamster
Gregor Favila|Gregor_Favila
Hector Fawley|Hector_Fawley
Eustace Fawley's father|Eustace_Fawley%27s_father
Lawrence Feldman|Lawrence_Feldman
Gato Felinus|Gato_Felinus
Mervyn Fenwick|Mervyn_Fenwick
Robbie Fenwick|Robbie_Fenwick
Fergus|Fergus
Alistair Fidgen|Alistair_Fidgen
Franciscus Fieldwake|Franciscus_Fieldwake
Limus Filhous|Limus_Filhous
Thomas Fillman|Thomas_Fillman
Fingal the Fearless|Fingal_the_Fearless
Barnabus Finkley|Barnabus_Finkley
Finn|Finn
Seamus Finnigan's father|Seamus_Finnigan%27s_father
Merwyn Finwick|Merwyn_Finwick
Fisher|Fisher
Angus Fleet|Angus_Fleet
Hedley Fleetwood|Hedley_Fleetwood
Phineas Fletcher|Phineas_Fletcher
Joshua Flexson|Joshua_Flexson
Gonalo Flores|Gon%C3%A7alo_Flores
Ambrosius Flume|Ambrosius_Flume
Agilbert Fontaine|Agilbert_Fontaine
Marlowe Forfang|Marlowe_Forfang
Freddy Forgione|Freddy_Forgione
Elphinstone Forgot|Elphinstone_Forgot
Dexter Fortescue|Dexter_Fortescue
Rufus Foster|Rufus_Foster
Edward Fountain|Edward_Fountain
Frank|Frank
Freckle-faced six-year-old's father|Freckle-faced_six-year-old%27s_father
Dietrich Frenzen|Dietrich_Frenzen
Friar|Friar
Otmar Frick|Otmar_Frick
Joseph Friend|Joseph_Friend
Denison Frisby|Denison_Frisby
Martin Frolik|Martin_Frolik
Fubster|Fubster
Rufus Fudge|Rufus_Fudge
Fuzzclaw|Fuzzclaw
Charlie G|Charlie_G
Arthur G.|Arthur_G.
Louis Gage|Louis_Gage
Mathis Gage|Mathis_Gage
Reynard Gage|Reynard_Gage
Brian Gagwilde III|Brian_Gagwilde_III
Brian Gagwilde|Brian_Gagwilde
Brian Gallagher|Brian_Gallagher
William Gallagher|William_Gallagher
Garrick Ollivander's peacock|Garrick_Ollivander%27s_peacock
John Garry|John_Garry
C. J. Gebauhr|C._J._Gebauhr
Ghost of a ragged man wearing chains|Ghost_of_a_ragged_man_wearing_chains
Portly ghost|Portly_ghost
Ghost of a highwayman|Ghost_of_a_highwayman
Unidentified ghost (VII)|Unidentified_ghost_(VII)
Ghost who played Sir Nicholas de Mimsy-Porpington's executioner|Ghost_who_played_Sir_Nicholas_de_Mimsy-Porpington%27s_executioner
Giffard Abbott's dog|Giffard_Abbott%27s_dog
Toby Gleaves|Toby_Gleaves
Glen|Glen
Goblet of Fire casket carriers|Goblet_of_Fire_casket_carriers
Melvin Godfrey|Melvin_Godfrey
Godric's Hollow Muggle boy|Godric%27s_Hollow_Muggle_boy
Goldstein sisters' grandfather|Goldstein_sisters%27_grandfather
Dragomir Gorgovitch|Dragomir_Gorgovitch
Gorilla at the Zoo|Gorilla_at_the_Zoo
Gormless Morgan|Gormless_Morgan
Gormless Morgan's boss|Gormless_Morgan%27s_boss
Miranda Goshawk's father|Miranda_Goshawk%27s_father
Gossamer|Gossamer
Harold Grace|Harold_Grace
Hermione Granger's father|Hermione_Granger%27s_father
Grawp's father|Grawp%27s_father
Franklin Greenwood|Franklin_Greenwood
Richard Griffiths (in-universe)|Richard_Griffiths_(in-universe)
Elias Grimstone|Elias_Grimstone
Gringotts Guards|Gringotts_Guards
Gringotts Head Goblin|Gringotts_Head_Goblin
Group of injured Giants|Group_of_injured_Giants
Galvin Gudgeon|Galvin_Gudgeon
Unidentified guitarist|Unidentified_guitarist
Alastor Gumboil|Alastor_Gumboil
Arnold Guzman|Arnold_Guzman
Timothy Hale|Timothy_Hale
Edwin Halsted|Edwin_Halsted
Wu Han Po|Wu_Han_Po
Handsome Poltergeist|Handsome_Poltergeist
Shimmy Hardoteer|Shimmy_Hardoteer
Ciceron Harkiss|Ciceron_Harkiss
Warty Harris|Warty_Harris
Kenneth Hastings|Kenneth_Hastings
Howard Haywood|Howard_Haywood
Penny Haywood's father|Penny_Haywood%27s_father
Unidentified resting headmaster|Unidentified_resting_headmaster
Headmaster of Castelobruxo during 1989|Headmaster_of_Castelobruxo_during_1989
Heady|Heady
Portrait of the Healers|Portrait_of_the_Healers
Reginald Heartachus|Reginald_Heartachus
Ralph Heidelberger|Ralph_Heidelberger
Martin Helstrom|Martin_Helstrom
Henerick|Henerick
Henry|Henry
Hermes|Hermes
Oakden Hernshaw|Oakden_Hernshaw
David Heyman (in-universe)|David_Heyman_(in-universe)
Chester Hidland|Chester_Hidland
Higglebottom|Higglebottom
Bertie Higgs|Bertie_Higgs
Bob Hitchens|Bob_Hitchens
Hilliard Hobday|Hilliard_Hobday
Oakden Hobday|Oakden_Hobday
Stefan Hoghedge|Stefan_Hoghedge
Hogsmeade street sweeper|Hogsmeade_street_sweeper
Pink-faced Hogwarts Headmaster|Pink-faced_Hogwarts_Headmaster
John Homme|John_Homme
Honoria's fianc|Honoria%27s_fianc%C3%A9
Hooky|Hooky
Kevin Hopwood|Kevin_Hopwood
Horace|Horace
Olive Hornby's brother|Olive_Hornby%27s_brother
Louis Hubbard|Louis_Hubbard
Chris Huhne|Chris_Huhne
Emanuel Hurwitz|Emanuel_Hurwitz
Clairvius Hyppolite|Clairvius_Hyppolite
Royston Idlewind|Royston_Idlewind
Jacob Kowlaski's foreman|Jacob_Kowlaski%27s_foreman
Jacob's father|Jacob%27s_father
Bastien Janvier|Bastien_Janvier
Jason Caffoe|Jason_Caffoe
Joey Jenkins|Joey_Jenkins
Leonard Jewkes|Leonard_Jewkes
Arsenius Jigger|Arsenius_Jigger
Jim|Jim
Jack Jodieman|Jack_Jodieman
John Terry|John_Terry
Angelina Johnson's father|Angelina_Johnson%27s_father
Sylvian Jolicoeur|Sylvian_Jolicoeur
Stuart Jones|Stuart_Jones
Johannes Jonker|Johannes_Jonker
Johannes Jonker's father|Johannes_Jonker%27s_father
Lee Jordan's father|Lee_Jordan%27s_father
Albert Jorkins|Albert_Jorkins
Granville Jorkins|Granville_Jorkins
Grimwold Jorkins|Grimwold_Jorkins
Stamford Jorkins|Stamford_Jorkins
Samuel Journeux|Samuel_Journeux
Judges of the 1379 duelling contest|Judges_of_the_1379_duelling_contest
Herman Junker|Herman_Junker
Ferdinand Jgendorf|Ferdinand_J%C3%A4gendorf
Tulip Karasu's father|Tulip_Karasu%27s_father
Karkaroffs Aide|Karkaroff%E2%80%99s_Aide
Lukas Karuzos|Lukas_Karuzos
Luxo Karuzos|Luxo_Karuzos
Luxo Karuzos II|Luxo_Karuzos_II
Keeper of the reptile house|Keeper_of_the_reptile_house
John Kent|John_Kent
Clifford Kessler|Clifford_Kessler
Silvanus Kettleburn's father|Silvanus_Kettleburn%27s_father
Kevin's father|Kevin%27s_father
Rowan Khanna's father|Rowan_Khanna%27s_father
Kazu Kibuishi|Kazu_Kibuishi
Jimmy Kiddell|Jimmy_Kiddell
Aidan Kiely|Aidan_Kiely
James Killick|James_Killick
King's Cross Station guard|King%27s_Cross_Station_guard
Marilias Kistmanus|Marilias_Kistmanus
Jacob Kowalski's grandfather|Jacob_Kowalski%27s_grandfather
Quentin Kowalski|Quentin_Kowalski
Viktor Krum's father|Viktor_Krum%27s_father
Laith|Laith
Lamont|Lamont
Hector Lamont|Hector_Lamont
Lancelot (Healer)|Lancelot_(Healer)
Landlord of The Hanged Man|Landlord_of_The_Hanged_Man
Wallace Lassiter|Wallace_Lassiter
Jean-Jacques Launier|Jean-Jacques_Launier
Joe Laurie|Joe_Laurie
Artemius Lawson|Artemius_Lawson
Nobby Leach|Nobby_Leach
Wizard in the Leaky Cauldron|Wizard_in_the_Leaky_Cauldron
Unidentified Leaky Cauldron client|Unidentified_Leaky_Cauldron_client
Leaky Cauldron wizard from Belgium|Leaky_Cauldron_wizard_from_Belgium
Leon|Leon
Corvus Lestrange (II)|Corvus_Lestrange_(II)
Cyrille Lestrange (II)|Cyrille_Lestrange_(II)
Cyrille Lestrange (III)|Cyrille_Lestrange_(III)
Cyrille Lestrange (IV)|Cyrille_Lestrange_(IV)
Floxel Lestrange|Floxel_Lestrange
Fulcran Lestrange (I)|Fulcran_Lestrange_(I)
Fulcran Lestrange (II)|Fulcran_Lestrange_(II)
Fulcran Lestrange (III)|Fulcran_Lestrange_(III)
Eduardo Lima (in-universe)|Eduardo_Lima_(in-universe)
Eduardus Lima|Eduardus_Lima
Edwardus Lima|Edwardus_Lima
Maxwell Lima|Maxwell_Lima
Limebert|Limebert
Limunus|Limunus
Eduardus Limus (Ministry employee)|Eduardus_Limus_(Ministry_employee)
Luciano Limus|Luciano_Limus
Miro Limus|Miro_Limus
Matheus Limusa|Matheus_Limusa
Little Hangleton milkman|Little_Hangleton_milkman
Little Whinging postman|Little_Whinging_postman
Chiara Lobosca's father|Chiara_Lobosca%27s_father
Gilderoy Lockhart's father|Gilderoy_Lockhart%27s_father
Bernard Lockwood|Bernard_Lockwood
Jack London|Jack_London
Harfang Longbottom's son|Harfang_Longbottom%27s_son
Algie Longbottom|Algie_Longbottom
Harfang Longbottom|Harfang_Longbottom
Jim Luna|Jim_Luna
Lars Lundekvam|Lars_Lundekvam
Clive Lundquist|Clive_Lundquist
Chris Lunney|Chris_Lunney
Aidan Lynch|Aidan_Lynch
Quintius MacBoon|Quintius_MacBoon
Magnus MacDonald|Magnus_MacDonald
Hamish MacFarlan|Hamish_MacFarlan
Alasdair Maddock|Alasdair_Maddock
Magical Menagerie salesman|Magical_Menagerie_salesman
Edmund Major II|Edmund_Major_II
Theopholos Malentus|Theopholos_Malentus
Armand Malfoy|Armand_Malfoy
Man who gave Mr Roberts Galleons|Man_who_gave_Mr_Roberts_Galleons
Man with knowledge of the Taboo|Man_with_knowledge_of_the_Taboo
Manager at Eeylops Owl Emporium|Manager_at_Eeylops_Owl_Emporium
Manager of Flourish and Blotts|Manager_of_Flourish_and_Blotts
Quiac Marinus|Quiac_Marinus
Martha Steward II's husband|Martha_Steward_II%27s_husband
Dylan Marwood|Dylan_Marwood
Mason|Mason
Olympe Maxime's father|Olympe_Maxime%27s_father
Maxwell|Maxwell
Eugene McAllister|Eugene_McAllister
Dougal McBride|Dougal_McBride
Albert McCausland|Albert_McCausland
Malcolm McGonagall|Malcolm_McGonagall
Robert McGonagall Senior|Robert_McGonagall_Senior
Robert McGonagall Senior's father|Robert_McGonagall_Senior%27s_father
Dougal McGregor's father|Dougal_McGregor%27s_father
Dougal McGregor's father-in-law|Dougal_McGregor%27s_father-in-law
Jim McGuffin|Jim_McGuffin
Cormac McLaggen's father|Cormac_McLaggen%27s_father
Cormack McLeod|Cormack_McLeod
Mentor Metaxas|Mentor_Metaxas
Eloise Midgen's father|Eloise_Midgen%27s_father
Luc Millefeuille|Luc_Millefeuille
Harold Minchum|Harold_Minchum
Minerva McGonagall's hornbill|Minerva_McGonagall%27s_hornbill
Minister for Magic Support Staff official|Minister_for_Magic_Support_Staff_official
Ministry guard|Ministry_guard
Ministry of Magic lift attendant|Ministry_of_Magic_lift_attendant
Ministry of Magic meeting assigner|Ministry_of_Magic_meeting_assigner
Unidentified Ministry of Magic Wizard at the 1994 Quidditch World Cup|Unidentified_Ministry_of_Magic_Wizard_at_the_1994_Quidditch_World_Cup
Marcus Minugius|Marcus_Minugius
Jacques Miskine|Jacques_Miskine
Tobias Misslethorpe|Tobias_Misslethorpe
Lars Moberly|Lars_Moberly
Cuthbert Mockridge|Cuthbert_Mockridge
Arnulf Moe|Arnulf_Moe
Dave Monk|Dave_Monk
Graham Montague's father|Graham_Montague%27s_father
Tiago Montoya|Tiago_Montoya
Alastor Moody's father|Alastor_Moody%27s_father
Dennis Moon|Dennis_Moon
Ethelbard Mordaunt|Ethelbard_Mordaunt
Kevinus Morrisons|Kevinus_Morrisons
Mortlake|Mortlake
Hassan Mostafa|Hassan_Mostafa
Neil La Mounte|Neil_La_Mounte
Mr Paws|Mr_Paws
Mr Tibbles|Mr_Tibbles
Mr Whiskers|Mr_Whiskers
Unidentified Muggle driver|Unidentified_Muggle_driver
Unidentified Muggle man who accidentally pushed Harry Potter in 1991|Unidentified_Muggle_man_who_accidentally_pushed_Harry_Potter_in_1991
Newspaper seller|Newspaper_seller
Unidentified male Muggle Studies teacher|Unidentified_male_Muggle_Studies_teacher
Zacharias Mumps|Zacharias_Mumps
Eric Munch|Eric_Munch
Ismelda Murk's father|Ismelda_Murk%27s_father
Caua Nemerus|Caua_Nemerus
Nepali wizard|Nepali_wizard
Nicholas de Mimsy-Porpington's executioner|Nicholas_de_Mimsy-Porpington%27s_executioner
Nigel's nephew's father|Nigel%27s_nephew%27s_father
Nobby|Nobby
Unidentified nose-picking wizard|Unidentified_nose-picking_wizard
Cantankerus Nott|Cantankerus_Nott
Jonny Nuhaka|Jonny_Nuhaka
NYPD Police Officer No. 743|NYPD_Police_Officer_No._743
Darren O'Hare|Darren_O%27Hare
Otto Obermeier|Otto_Obermeier
Oblansk|Oblansk
Roberts' Obliviator|Roberts%27_Obliviator
Odbert|Odbert
Odbert's father|Odbert%27s_father
Winkus Oddpick|Winkus_Oddpick
Odo|Odo
Tiberius Ogden|Tiberius_Ogden
Ogg|Ogg
Olaf|Olaf
Old Man in Portrait|Old_Man_in_Portrait
Barnaby Ollerton|Barnaby_Ollerton
Bill Ollerton|Bill_Ollerton
Bob Ollerton|Bob_Ollerton
Ollie|Ollie
Garrick Ollivander's son|Garrick_Ollivander%27s_son
A. Osborn|A._Osborn
George Osborne|George_Osborne
Over-attentive wizard|Over-attentive_wizard
P. Oxley|P._Oxley
Painting of sinister-looking monks|Painting_of_sinister-looking_monks
Rodrigo Palombo|Rodrigo_Palombo
Des Pander|Des_Pander
Patil twins' father|Patil_twins%27_father
Payne|Payne
Arnold Peasegood|Arnold_Peasegood
Angelus Peel|Angelus_Peel
Edward Almeida Peidus|Edward_Almeida_Peidus
Phoebus Penrose|Phoebus_Penrose
Bertrand de Penses-Profondes|Bertrand_de_Pens%C3%A9es-Profondes
Octavius Pepper|Octavius_Pepper
Perkins|Perkins
Russell Perkins|Russell_Perkins
Sebastien Perrot|Sebastien_Perrot
Albert Perschky|Albert_Perschky
Peter (portrait)|Peter_(portrait)
Arkie Philpott|Arkie_Philpott
Miras Phlaras|Miras_Phlaras
Emerett Picardy|Emerett_Picardy
Constance Pickering's brother (II)|Constance_Pickering%27s_brother_(II)
Constance Pickering's grandfather|Constance_Pickering%27s_grandfather
Constance Pickering's muggle grandfather|Constance_Pickering%27s_muggle_grandfather
Pigwidgeon|Pigwidgeon
Pinky|Pinky
Dagbert Pips|Dagbert_Pips
Radolphus Pittiman|Radolphus_Pittiman
Pitts|Pitts
Pius Thicknesse's sycophants|Pius_Thicknesse%27s_sycophants
Platform Nine and Three-Quarters station guard|Platform_Nine_and_Three-Quarters_station_guard
Vladimir Plot|Vladimir_Plot
Josiah Plunkett|Josiah_Plunkett
Mirabella Plunkett's father|Mirabella_Plunkett%27s_father
Samuel Plunkett|Samuel_Plunkett
Hector Podmore|Hector_Podmore
Royden Poke|Royden_Poke
Rutherford Poke|Rutherford_Poke
Poliakoff|Poliakoff
Roddy Pontner|Roddy_Pontner
Ivan Popa|Ivan_Popa
Portrait at the Storeroom (sixth floor)|Portrait_at_the_Storeroom_(sixth_floor)
Portrait of a mad old man|Portrait_of_a_mad_old_man
Portrait of a male nurse in the hospital wing|Portrait_of_a_male_nurse_in_the_hospital_wing
Portrait of a man on a flying carpet|Portrait_of_a_man_on_a_flying_carpet
Portrait of a scholar|Portrait_of_a_scholar
Portrait of a sleeping hermit|Portrait_of_a_sleeping_hermit
Portrait of a wizard by a rope|Portrait_of_a_wizard_by_a_rope
Portrait of a wizard in black|Portrait_of_a_wizard_in_black
Portrait of a wizard in black flowing robes|Portrait_of_a_wizard_in_black_flowing_robes
Portrait of a wizard in blue|Portrait_of_a_wizard_in_blue
Portrait of a wizard in red|Portrait_of_a_wizard_in_red
Portrait of a wizard with a broomstick|Portrait_of_a_wizard_with_a_broomstick
Portrait of a wizard with a walrus moustache|Portrait_of_a_wizard_with_a_walrus_moustache
Charlus Potter's son|Charlus_Potter%27s_son
Hardwin Potter|Hardwin_Potter
Ralston Potter|Ralston_Potter
Nugent Potts|Nugent_Potts
Prendergast|Prendergast
Prentice|Prentice
Ignatius Prewett|Ignatius_Prewett
Molly Weasley's father|Molly_Weasley%27s_father
Priest who comforted Nicholas de Mimsy-Porpington|Priest_who_comforted_Nicholas_de_Mimsy-Porpington
Prime Minister's predecessor|Prime_Minister%27s_predecessor
Apollyon Pringle|Apollyon_Pringle
Portrait of a Professor|Portrait_of_a_Professor
Chroniculus Punnet|Chroniculus_Punnet
Augustus Pye|Augustus_Pye
Lancaster Pyke|Lancaster_Pyke
Argo Pyrites|Argo_Pyrites
Portrait of a Quidditch player|Portrait_of_a_Quidditch_player
Unidentified Quidditch referee|Unidentified_Quidditch_referee
Quidditch World Cup programme seller|Quidditch_World_Cup_programme_seller
Quigley|Quigley
Finbar Quigley|Finbar_Quigley
Cranville Quincey|Cranville_Quincey
Thiago Quintana|Thiago_Quintana
Edward Rabnott|Edward_Rabnott
Daniel Radcliffe (in-universe)|Daniel_Radcliffe_(in-universe)
Radulf|Radulf
Ragnok|Ragnok
Ragnok the Pigeon-Toed|Ragnok_the_Pigeon-Toed
Erika Rath's father|Erika_Rath%27s_father
Hengist Rawkes|Hengist_Rawkes
Reading visitor in the Three Broomsticks Inn|Reading_visitor_in_the_Three_Broomsticks_Inn
Reginald Oddpick|Reginald_Oddpick
Maisy Reynolds's father|Maisy_Reynolds%27s_father
Iefan Rice|Iefan_Rice
Roy Rifenderg|Roy_Rifenderg
Gawain Robards|Gawain_Robards
Romanian vampire|Romanian_vampire
Wallace Rosenberg|Wallace_Rosenberg
Ross|Ross
Isobel Ross's father|Isobel_Ross%27s_father
Rowan Khanna's uncle|Rowan_Khanna%27s_uncle
Rowboat owner|Rowboat_owner
Greg Ruczinski|Greg_Ruczinski
Grugwyn Rufford|Grugwyn_Rufford
Barry Ryan|Barry_Ryan
W. de S. Trenholm|W._de_S._Trenholm
Herb Salient|Herb_Salient
Albert Sallow|Albert_Sallow
Sam (Obliviator)|Sam_(Obliviator)
Sam (vandal)|Sam_(vandal)
Sanguini|Sanguini
Joshua Sankara|Joshua_Sankara
Rafael Santos|Rafael_Santos
Nicholas Saunders (in-universe)|Nicholas_Saunders_(in-universe)
George Savill|George_Savill
Bruno Schmidt|Bruno_Schmidt
Bruno Schmidt's father|Bruno_Schmidt%27s_father
Scouthibou|Scouthibou
Brutus Scrimgeour|Brutus_Scrimgeour
Sean|Sean
Sebastian|Sebastian
Nelson Selgado|Nelson_Selgado
Shafiq (1920s)|Shafiq_(1920s)
D. Shaman|D._Shaman
Temeritus Shanks|Temeritus_Shanks
Henry Shaw Senior|Henry_Shaw_Senior
Langdon Shaw|Langdon_Shaw
Marshall Sheridan|Marshall_Sheridan
Shifty wizard|Shifty_wizard
Stanley Shilling|Stanley_Shilling
Shrunken heads in the Three Broomsticks|Shrunken_heads_in_the_Three_Broomsticks
Tony Silva|Tony_Silva
Mylor Silvanus|Mylor_Silvanus
Alvin Simmons|Alvin_Simmons
George Sipel|George_Sipel
Sir Ribbithe|Sir_Ribbithe
Harold Skively|Harold_Skively
Wilbert Slinkhard|Wilbert_Slinkhard
Horace Slughorn's friend|Horace_Slughorn%27s_friend
Darius Smackhammer|Darius_Smackhammer
Hippocrates Smethwyck|Hippocrates_Smethwyck
Carl Smiley|Carl_Smiley
Smirnoff|Smirnoff
Zacharias Smith's father|Zacharias_Smith%27s_father
Andy Smudgley|Andy_Smudgley
Tobias Snape|Tobias_Snape
Joseph Snuka|Joseph_Snuka
Lucas Sparrowvale|Lucas_Sparrowvale
Spectrum|Spectrum
Leonard Spencer-Moon|Leonard_Spencer-Moon
Oraclitus Spheer|Oraclitus_Spheer
Rudolph Spielman|Rudolph_Spielman
Oddvar Spillum|Oddvar_Spillum
Helbert Spleen|Helbert_Spleen
Frederick Springer|Frederick_Springer
Able Spudmore|Able_Spudmore
Randolph Spudmore|Randolph_Spudmore
Squat wizard in a purple pork-pie hat|Squat_wizard_in_a_purple_pork-pie_hat
Unidentified St Mungo's girl patient's father|Unidentified_St_Mungo%27s_girl_patient%27s_father
Staring Portrait|Staring_Portrait
Paul Stark|Paul_Stark
Stebbins (1920s)|Stebbins_(1920s)
Steve|Steve
Steve McClaren|Steve_McClaren
Douglas Steward|Douglas_Steward
Quintus Stranger|Quintus_Stranger
Theo Strongarm|Theo_Strongarm
Estaban Stubbe|Estaban_Stubbe
Billy Stubbs|Billy_Stubbs
Surrey milkman|Surrey_milkman
Stephen Swain|Stephen_Swain
Emeric Switch|Emeric_Switch
Amrose Swott|Amrose_Swott
Ted|Ted
Tenebrus|Tenebrus
Third semi-finalist of the 1379 duelling contest|Third_semi-finalist_of_the_1379_duelling_contest
Dean Thomas's stepfather|Dean_Thomas%27s_stepfather
Thomson's nephew|Thomson%27s_nephew
Tim|Tim
Titus|Titus
Todd Arnow|Todd_Arnow
Tom|Tom
Tom (Bowtruckle)|Tom_(Bowtruckle)
Tom (vandal)|Tom_(vandal)
Garius Tomkink|Garius_Tomkink
Torvus' father|Torvus%27_father
Boniface Toubeau|Boniface_Toubeau
Trading Card Shop shopkeeper|Trading_Card_Shop_shopkeeper
Transylvanian farmer|Transylvanian_farmer
Sybill Trelawney's father|Sybill_Trelawney%27s_father
Bernard Tremblay|Bernard_Tremblay
Falco Tremblay|Falco_Tremblay
Mason Tremblay|Mason_Tremblay
Donaghan Tremlett's father|Donaghan_Tremlett%27s_father
Harry Trigg|Harry_Trigg
Quentin Trimble|Quentin_Trimble
Trocar|Trocar
Troy|Troy
Ignatius Tuft|Ignatius_Tuft
Lottie Turner's father|Lottie_Turner%27s_father
Liz Tuttle's maternal grandfather|Liz_Tuttle%27s_maternal_grandfather
Norman Tuttle|Norman_Tuttle
Unidentified TV weatherman|Unidentified_TV_weatherman
Mark Twain|Mark_Twain
Mallory Twiddle|Mallory_Twiddle
Two Unidentified Ministry Guards|Two_Unidentified_Ministry_Guards
Wilkie Twycross|Wilkie_Twycross
Dolores Umbridge's brother|Dolores_Umbridge%27s_brother
Orford Umbridge|Orford_Umbridge
Quintius Umfraville|Quintius_Umfraville
Uncle Edward|Uncle_Edward
Fytherley Undercliffe|Fytherley_Undercliffe
Unidentified 1985-1986 Defence Against the Dark Arts teacher|Unidentified_1985-1986_Defence_Against_the_Dark_Arts_teacher
Unidentified 1992 - 1993 Music teacher|Unidentified_1992_-_1993_Music_teacher
Unidentified 19th-century Potions professor|Unidentified_19th-century_Potions_professor
Unidentified Australian wizard|Unidentified_Australian_wizard
Unidentified balding Ministry of Magic employee|Unidentified_balding_Ministry_of_Magic_employee
Unidentified bank begging tramp|Unidentified_bank_begging_tramp
Unidentified bank employee|Unidentified_bank_employee
Unidentified bank guard|Unidentified_bank_guard
Unidentified bearded centaur|Unidentified_bearded_centaur
Unidentified boy who transfigured his friend|Unidentified_boy_who_transfigured_his_friend
Unidentified bushily whiskered Ministry of Magic employee|Unidentified_bushily_whiskered_Ministry_of_Magic_employee
Unidentified Bushy Haired Muttering Wizard|Unidentified_Bushy_Haired_Muttering_Wizard
Unidentified centaur|Unidentified_centaur
Unidentified child in bubble|Unidentified_child_in_bubble
Unidentified clown|Unidentified_clown
Unidentified Council of Magical Law clerk|Unidentified_Council_of_Magical_Law_clerk
Unidentified Customs official|Unidentified_Customs_official
Unidentified Customs official (II)|Unidentified_Customs_official_(II)
Unidentified Department of Magical Games and Sports representative|Unidentified_Department_of_Magical_Games_and_Sports_representative
Unidentified dumpy Wizengamot member with a large black moustache|Unidentified_dumpy_Wizengamot_member_with_a_large_black_moustache
Unidentified dun-coloured centaur|Unidentified_dun-coloured_centaur
Unidentified Durmstrang students|Unidentified_Durmstrang_students
Unidentified dustman|Unidentified_dustman
Unidentified executioner (II)|Unidentified_executioner_(II)
Unidentified falling man|Unidentified_falling_man
Unidentified fire-breather|Unidentified_fire-breather
Unidentified French policeman|Unidentified_French_policeman
Unidentified frowning Ministry of Magic wizard who murmured instructions to a quill|Unidentified_frowning_Ministry_of_Magic_wizard_who_murmured_instructions_to_a_quill
Unidentified giant in the Blind Pig|Unidentified_giant_in_the_Blind_Pig
Unidentified goalkeeper|Unidentified_goalkeeper
Unidentified Goblin at Gringotts (I)|Unidentified_Goblin_at_Gringotts_(I)
Unidentified Goblin at Gringotts in 1998 (VII)|Unidentified_Goblin_at_Gringotts_in_1998_(VII)
Unidentified Goblin Caroler (I)|Unidentified_Goblin_Caroler_(I)
Unidentified grandfather|Unidentified_grandfather
Unidentified Gringotts Bank goblin guard|Unidentified_Gringotts_Bank_goblin_guard
Unidentified grubby-looking wizard|Unidentified_grubby-looking_wizard
Unidentified hard-faced grey centaur|Unidentified_hard-faced_grey_centaur
Unidentified Headmaster with Scroll|Unidentified_Headmaster_with_Scroll
Unidentified hobo|Unidentified_hobo
Unidentified insulting wizard|Unidentified_insulting_wizard
Unidentified Irishman|Unidentified_Irishman
Unidentified irritated Muggle man|Unidentified_irritated_Muggle_man
Unidentified juggler at the 422nd Quidditch World Cup|Unidentified_juggler_at_the_422nd_Quidditch_World_Cup
Unidentified Magical Maintenance wizard|Unidentified_Magical_Maintenance_wizard
Unidentified male Charms Professor|Unidentified_male_Charms_Professor
Unidentified Male Muggle looking at Rubeus Hagrid in 1991|Unidentified_Male_Muggle_looking_at_Rubeus_Hagrid_in_1991
Unidentified man in Borgin and Burkes in 1996|Unidentified_man_in_Borgin_and_Burkes_in_1996
Unidentified man that yelled the Death Eaters were coming|Unidentified_man_that_yelled_the_Death_Eaters_were_coming
Unidentified Merman|Unidentified_Merman
Unidentified Ministry of Magic visitor with a big curled moustache|Unidentified_Ministry_of_Magic_visitor_with_a_big_curled_moustache
Unidentified Ministry Wizard (I)|Unidentified_Ministry_Wizard_(I)
Unidentified Ministry Wizard in 1997 (I)|Unidentified_Ministry_Wizard_in_1997_(I)
Unidentified Muggle football commentator|Unidentified_Muggle_football_commentator
Unidentified Muggle man with newspaper|Unidentified_Muggle_man_with_newspaper
Unidentified Muggle radio host|Unidentified_Muggle_radio_host
Unidentified Muggle woman (III)'s son|Unidentified_Muggle_woman_(III)%27s_son
Unidentified nearby wizard|Unidentified_nearby_wizard
Unidentified newspaper boy|Unidentified_newspaper_boy
Unidentified pet-owner in Knockturn Alley|Unidentified_pet-owner_in_Knockturn_Alley
Unidentified photographer (I)|Unidentified_photographer_(I)
Unidentified photographer (II)|Unidentified_photographer_(II)
Unidentified police officer (I)|Unidentified_police_officer_(I)
Unidentified police officer (II)|Unidentified_police_officer_(II)
Unidentified portrait in Malfoy Manor (II)|Unidentified_portrait_in_Malfoy_Manor_(II)
Unidentified Pumpkin Juice seller at the Quidditch World Cup|Unidentified_Pumpkin_Juice_seller_at_the_Quidditch_World_Cup
Unidentified reporter|Unidentified_reporter
Unidentified Sleeping Headmaster 1568AD|Unidentified_Sleeping_Headmaster_1568AD
Unidentified Sleeping Headmaster in Blue|Unidentified_Sleeping_Headmaster_in_Blue
Unidentified Sleeping Headmaster in Gold|Unidentified_Sleeping_Headmaster_in_Gold
Unidentified Sleeping Headmaster with Apple|Unidentified_Sleeping_Headmaster_with_Apple
Unidentified Sleeping Headmaster with Astrolabe|Unidentified_Sleeping_Headmaster_with_Astrolabe
Unidentified Sleeping Headmaster with Book|Unidentified_Sleeping_Headmaster_with_Book
Unidentified Sleeping Headmaster with Castle Sketch|Unidentified_Sleeping_Headmaster_with_Castle_Sketch
Unidentified Sleeping Headmaster with Paper|Unidentified_Sleeping_Headmaster_with_Paper
Unidentified Sleeping Headmaster with Starmap|Unidentified_Sleeping_Headmaster_with_Starmap
Unidentified Slug Club Christmas party attendee|Unidentified_Slug_Club_Christmas_party_attendee
Unidentified son|Unidentified_son
Unidentified watchman|Unidentified_watchman
Unidentified witness|Unidentified_witness
Unidentified wizard at Platform Nine and Three-Quarters|Unidentified_wizard_at_Platform_Nine_and_Three-Quarters
Unidentified wizard at Platform Nine and Three-Quarters (II)|Unidentified_wizard_at_Platform_Nine_and_Three-Quarters_(II)
Unidentified wizard at Platform Nine and Three-Quarters (III)|Unidentified_wizard_at_Platform_Nine_and_Three-Quarters_(III)
Unidentified Wizards in the Hog's Head|Unidentified_Wizards_in_the_Hog%27s_Head
Unidentified young husband|Unidentified_young_husband
Unidentified young man|Unidentified_young_man
Unnamed Kwidditch players|Unnamed_Kwidditch_players
Urg the Unclean|Urg_the_Unclean
Urgruff the Unwary|Urgruff_the_Unwary
Laurent Varcy|Laurent_Varcy
Milford Vessel|Milford_Vessel
Violet-cloaked wizard|Violet-cloaked_wizard
Vindictus Viridian|Vindictus_Viridian
Luciano Volpi|Luciano_Volpi
Boris Vulchanov|Boris_Vulchanov
Vulpus|Vulpus
Waiter at the Three Broomsticks|Waiter_at_the_Three_Broomsticks
Waiter in The Leaky Cauldron|Waiter_in_The_Leaky_Cauldron
Waiter serving Dragon Tartare|Waiter_serving_Dragon_Tartare
Waiters at William Weasley and Fleur Delacour's wedding|Waiters_at_William_Weasley_and_Fleur_Delacour%27s_wedding
Laurence Wakefield|Laurence_Wakefield
Karl Wang|Karl_Wang
Celestina Warbeck's father|Celestina_Warbeck%27s_father
Celestina Warbeck's first husband|Celestina_Warbeck%27s_first_husband
Celestina Warbeck's second husband|Celestina_Warbeck%27s_second_husband
Celestina Warbeck's son|Celestina_Warbeck%27s_son
Irving Warble|Irving_Warble
Jeremius Wardwart|Jeremius_Wardwart
Myrtle Warren's father|Myrtle_Warren%27s_father
Warrington sisters' father|Warrington_sisters%27_father
Wealthy man who owned the Riddle House|Wealthy_man_who_owned_the_Riddle_House
Weasley children's uncle|Weasley_children%27s_uncle
Weasley family ghoul|Weasley_family_ghoul
Molly Weasley's second cousin|Molly_Weasley%27s_second_cousin
Fred Weasley II|Fred_Weasley_II
Alec Webb|Alec_Webb
H. G. Wells|H._G._Wells
Norman Wesley|Norman_Wesley
Rich West|Rich_West
Whispering wizard|Whispering_wizard
Hadrian Whittle|Hadrian_Whittle
Hermann Wiel|Hermann_Wiel
Dempster Wiggleswade|Dempster_Wiggleswade
Wilhelm Wigworthy|Wilhelm_Wigworthy
Maurice Willard|Maurice_Willard
Clyde Sizemore|Clyde_Sizemore
Maurice Willards|Maurice_Willards
Benjy Williams|Benjy_Williams
Williamson|Williamson
Tom Wingrove|Tom_Wingrove
Rubens Winikus|Rubens_Winikus
Winston|Winston
Unidentified Wiseacre's Wizarding Equipment employee|Unidentified_Wiseacre%27s_Wizarding_Equipment_employee
Unidentified wizard in Knockturn Alley|Unidentified_wizard_in_Knockturn_Alley
Wizard who claimed to be a dragon killer|Wizard_who_claimed_to_be_a_dragon_killer
Wizard who claimed to be a Vampire Hunter|Wizard_who_claimed_to_be_a_Vampire_Hunter
Wladyslaw Wolfke|Wladyslaw_Wolfke
Jamie Wolpert (in-universe)|Jamie_Wolpert_(in-universe)
Oliver Wood's father|Oliver_Wood%27s_father
Robert Wood|Robert_Wood
Workmen at Tottenham Court Road|Workmen_at_Tottenham_Court_Road
Augustus Worme|Augustus_Worme
Momolu Wotorson|Momolu_Wotorson
Bowman Wright's father|Bowman_Wright%27s_father
Josef Wronski|Josef_Wronski
Bonawentura Wjcik|Bonawentura_W%C3%B3jcik
Georgios Xenakis|Georgios_Xenakis
J. B. Yabsley|J._B._Yabsley
Yarwood|Yarwood
David Yates (in-universe)|David_Yates_(in-universe)
Ye Olde Curiosity Shop shopkeeper|Ye_Olde_Curiosity_Shop_shopkeeper
Andy Young|Andy_Young
M. Young|M._Young
Ladislaw Zamojski|Ladislaw_Zamojski
Georgi Zdravko|Georgi_Zdravko
Alonzo Zema|Alonzo_Zema
Zeph Salvage|Zeph_Salvage
Lev Zograf|Lev_Zograf
Zonko|Zonko
Zoo director|Zoo_director
Sinistra|Sinistra
Sirius Black's barn owl|Sirius_Black%27s_barn_owl
Sirius Black's owl|Sirius_Black%27s_owl
Skye Parkin's cousin|Skye_Parkin%27s_cousin
Snowy|Snowy
Faris Spavin's secretary|Faris_Spavin%27s_secretary
Spellman|Spellman
Stark|Stark
Stormswift|Stormswift
Sybill Trelawney's cat|Sybill_Trelawney%27s_cat
Temeritus Shanks's owl|Temeritus_Shanks%27s_owl
The Toad|The_Toad
Transylvanian Head of Magical Cooperation|Transylvanian_Head_of_Magical_Cooperation
Tufty|Tufty
Tut|Tut
Twinkle|Twinkle
Unidentified 1984-1985 Defence Against the Dark Arts teacher|Unidentified_1984-1985_Defence_Against_the_Dark_Arts_teacher
Unidentified 1986-1987 Defence Against the Dark Arts teacher|Unidentified_1986-1987_Defence_Against_the_Dark_Arts_teacher
Unidentified 1987-1988 Defence Against the Dark Arts teacher|Unidentified_1987-1988_Defence_Against_the_Dark_Arts_teacher
Unidentified 1989-1990 Defence Against the Dark Arts teacher|Unidentified_1989-1990_Defence_Against_the_Dark_Arts_teacher
Unidentified Aurors|Unidentified_Aurors
Unidentified Ballycastle Bats Chaser|Unidentified_Ballycastle_Bats_Chaser
Unidentified chestnut-coloured hippogriff|Unidentified_chestnut-coloured_hippogriff
Unidentified creature|Unidentified_creature
Unidentified crow|Unidentified_crow
Unidentified ghost horse (II)|Unidentified_ghost_horse_(II)
Unidentified goblin philosopher|Unidentified_goblin_philosopher
Unidentified Hogwarts librarian|Unidentified_Hogwarts_librarian
Unidentified house-elf near the Hogwarts kitchens|Unidentified_house-elf_near_the_Hogwarts_kitchens
Unidentified members of the Accidental Magic Reversal Squad|Unidentified_members_of_the_Accidental_Magic_Reversal_Squad
Unidentified radio presenter|Unidentified_radio_presenter
Vampire in Minsk|Vampire_in_Minsk
Visitor of the Three Broomsticks Inn|Visitor_of_the_Three_Broomsticks_Inn
F. Wakefield|F._Wakefield
L. Wakefield (wizard)|L._Wakefield_(wizard)
J. Ward|J._Ward
Weasleys' Puffskein|Weasleys%27_Puffskein
C. Williamsum|C._Williamsum
Wiseacre|Wiseacre
Wool|Wool
Erie Yenning|Erie_Yenning
R. Almeidas|R._Almeidas
M. Carneirus (British)|M._Carneirus_(British)
Daily Prophet chief sports writer|Daily_Prophet_chief_sports_writer
A. Fenetre|A._Fenetre
E. Limaria|E._Limaria
L. Limuria|L._Limuria
Paper-owl|Paper-owl
Kikis Trecus|Kikis_Trecus
Follo|Follo
Fractcumulus|Fractcumulus
Frantielo|Frantielo
Hadkiss|Hadkiss
Head Curse-Breaker|Head_Curse-Breaker
Head Goblin (title)|Head_Goblin_(title)
Nimbley|Nimbley
Nimbostratus|Nimbostratus
Rabat|Rabat
Willowborough|Willowborough
Astronomy department|Astronomy_department
Charms Master|Charms_Master
Head of House|Head_of_House
Hogwarts Caretaker|Hogwarts_Caretaker
Keeper of Keys and Grounds|Keeper_of_Keys_and_Grounds
Hogwarts Headmaster|Hogwarts_Headmaster
Portrait of a bearded man holding a book|Portrait_of_a_bearded_man_holding_a_book
Unidentified Sleeping Headmistress with Wand|Unidentified_Sleeping_Headmistress_with_Wand
Potions Master|Potions_Master
Knight Bus conductor|Knight_Bus_conductor
Knight Bus driver|Knight_Bus_driver
Investigative Team|Investigative_Team
President of the Magical Congress of the United States of America|President_of_the_Magical_Congress_of_the_United_States_of_America
Apparition Instructor|Apparition_Instructor
Minister for Magic|Minister_for_Magic
D. Dussal|D._Dussal
Executioner|Executioner
Obliviator Headquarters|Obliviator_Headquarters
Obliviator|Obliviator
Unidentified Obliviator|Unidentified_Obliviator
Unidentified Council of Magical Law member|Unidentified_Council_of_Magical_Law_member
Hit Wizard|Hit_Wizard
Arthur Weasley's ten unidentified subordinates|Arthur_Weasley%27s_ten_unidentified_subordinates
Unidentified Ministry of Magic Wizengamot Member (I)|Unidentified_Ministry_of_Magic_Wizengamot_Member_(I)
Unidentified three successive Chief Warlocks of the Wizengamot|Unidentified_three_successive_Chief_Warlocks_of_the_Wizengamot
Unspeakable|Unspeakable
Director of the Investigation Department and Ministry Police|Director_of_the_Investigation_Department_and_Ministry_Police
Minas|Minas
Advisor to the Minister for Magic|Advisor_to_the_Minister_for_Magic
Exotic Symbol Analyst|Exotic_Symbol_Analyst
Head of the Muggle-Born Registration Commission|Head_of_the_Muggle-Born_Registration_Commission
Junior Assistant to the Minister for Magic|Junior_Assistant_to_the_Minister_for_Magic
Minister for Magic and Support Staff|Minister_for_Magic_and_Support_Staff
Senior Undersecretary to the Minister for Magic|Senior_Undersecretary_to_the_Minister_for_Magic
Special Advisor for Elf Legislation|Special_Advisor_for_Elf_Legislation
Squeaky-voiced Ministry of Magic employee|Squeaky-voiced_Ministry_of_Magic_employee
F. L. Wakefield|F._L._Wakefield
Ollivander family|Ollivander_family
E. Lamb|E._Lamb
Behforooz|Behforooz
Turner|Turner
Bodrig the Boss-Eyed|Bodrig_the_Boss-Eyed
Bodrod the Bearded|Bodrod_the_Bearded
Arithmancer|Arithmancer
Nash|Nash
L. Wakefield (Muggle)|L._Wakefield_(Muggle)
E. Lima|E._Lima
Hogwarts Gobstones Team|Hogwarts_Gobstones_Team
Beater|Beater
Pringle|Pringle
Quidditch Captain|Quidditch_Captain
Chaser|Chaser
Elodie Dembl|Elodie_Demb%C3%A9l%C3%A9
Keeper|Keeper
Cyble Peltier|Cyb%C3%A8le_Peltier
Seeker|Seeker
Wakefield (Quidditch player)|Wakefield_(Quidditch_player)
Auror|Auror
W. Linden|W._Linden
Ortiz O'Flaherty|Ortiz_O%27Flaherty
Irsis Pius|Irsis_Pius
Bounty hunter|Bounty_hunter
Barker (wizard)|Barker_(wizard)
Broom-maker|Broom-maker
Flyte|Flyte
Picture of drunk monks|Picture_of_drunk_monks
S.J. Bernstein|S.J._Bernstein
Garrice|Garrice
Sonnleitner|Sonnleitner
Thomson|Thomson
M. Voltolini|M._Voltolini
Bolandi|Bolandi
Queenbee|Queenbee
Tamsin|Tamsin
TongueBurners Ltd|TongueBurners_Ltd
Dale Donahue|Dale_Donahue
Curse-Breaker|Curse-Breaker
Troupe of dancing skeletons|Troupe_of_dancing_skeletons
Adam John Blendick|Adam_John_Blendick
Carneiro Players|Carneiro_Players
Matelot|Matelot
Lima|Lima
Mina|Mina
Lamb & Neal|Lamb_%26_Neal
Magician|Magician
Big Mic|Big_Mic
The Bent-Winged Snitches|The_Bent-Winged_Snitches
The Blair Girls|The_Blair_Girls
Coldplay|Coldplay
Dollis Chamber Ensemble|Dollis_Chamber_Ensemble
Fred Baille & Co.|Fred_Baille_%26_Co.
Frog Choir|Frog_Choir
Gorillaz|Gorillaz
The Hobgoblins|The_Hobgoblins
Hogsmeade choir|Hogsmeade_choir
Hogwarts orchestra|Hogwarts_orchestra
Joe Sez No (band)|Joe_Sez_No_(band)
Nick Cave and the Bad Seeds|Nick_Cave_and_the_Bad_Seeds
Not Quite Right Opera Company|Not_Quite_Right_Opera_Company
The Ordinary Boys|The_Ordinary_Boys
The Quint Trio|The_Quint_Trio
The Rhythmic Runes|The_Rhythmic_Runes
The Shadow Men|The_Shadow_Men
Spellbound (group)|Spellbound_(group)
Team Calamity|Team_Calamity
The Value Engineers|The_Value_Engineers
Winter Parker Orchestra|Winter_Parker_Orchestra
Zombie Ghost Train|Zombie_Ghost_Train
Weird Sisters|Weird_Sisters
Musician|Musician
Groundskeeper at the Chudley Cannons' training ground|Groundskeeper_at_the_Chudley_Cannons%27_training_ground
Art historian|Art_historian
House-elves at the 1994 Quidditch World Cup|House-elves_at_the_1994_Quidditch_World_Cup
Part elf|Part_elf
Tiny Trotters|Tiny_Trotters
Yumbo|Yumbo
Garvin Lgner|Garvin_L%C3%BCgner
A. Criddle|A._Criddle
E. Dingbat|E._Dingbat
Jamie Wolpert (journalist)|Jamie_Wolpert_(journalist)
Karkaroffs Aide|Karkaroff%E2%80%99s_Aide
Theoretician|Theoretician
S. Redler|S._Redler
Dentist|Dentist
Surgical and Dental operator|Surgical_and_Dental_operator
Healer|Healer
Brown|Brown
Police|Police
Chancellor of the Exchequer|Chancellor_of_the_Exchequer
Junior minister|Junior_minister
Minister|Minister
President of the Council of Magic|President_of_the_Council_of_Magic
President of the United States of America|President_of_the_United_States_of_America
Prime Minister|Prime_Minister
Prime Minister (title)|Prime_Minister_(title)
Mazoni|Mazoni
Professor|Professor
Quidditch Commentator|Quidditch_Commentator
Quidditch referee|Quidditch_referee
Astronomer|Astronomer
Herbologist|Herbologist
Dragonologist|Dragonologist
Magizoologist|Magizoologist
Most Extraordinary Society of Potioneers|Most_Extraordinary_Society_of_Potioneers
Potioneer|Potioneer
Griffin|Griffin
Matagot|Matagot
Security troll|Security_troll
Security Warlock|Security_Warlock
Sphinx|Sphinx
Cavalier|Cavalier
Crusader|Crusader
Footman|Footman
Gryffindor Knight|Gryffindor_Knight
House-elf armour|House-elf_armour
Ice Knight|Ice_Knight
Knight|Knight
Paladin|Paladin
Squire|Squire
Swordsman|Swordsman
D. Abramowic|D._Abramowic
Blanchard|Blanchard
Blinkhorn|Blinkhorn
W. Campbell|W._Campbell
L. Caruso|L._Caruso
Concordia|Concordia
M. Dudziac|M._Dudziac
Gable|Gable
Greengrocer|Greengrocer
Hughes|Hughes
Walker (greengrocer)|Walker_(greengrocer)
V. Hahn|V._Hahn
M. N. Hora|M._N._Hora
Janek|Janek
C. D. McLeod|C._D._McLeod
Pelowski|Pelowski
Plunkett|Plunkett
Voclain|Voclain
Winstanley|Winstanley
Cosme Acajor|Cosme_Acajor
Wandmaker|Wandmaker
Shikoba Wolfe|Shikoba_Wolfe
Clase Lestrange|C%C3%A9l%C3%A9ase_Lestrange
Noza Lestrange (ne Trouche)|Noz%C3%A9a_Lestrange_(n%C3%A9e_Trouche)
Salom Lestrange|Salom%C3%A9_Lestrange
Cadmus Peverell's fiance|Cadmus_Peverell%27s_fianc%C3%A9e
Flicule Lestrange|F%C3%A9licule_Lestrange
Euphralde Lestrange|Euphra%C3%AFlde_Lestrange
Half-blood|Half-blood
Half-giant|Half-giant
Half-goblin|Half-goblin
Half-Veela|Half-Veela
Half-breed|Half-breed
Part-troll|Part-troll
Part-vampire|Part-vampire
Muggle-born|Muggle-born
Cassandra's uncle|Cassandra%27s_uncle
Dudley Dursley's opponent for the Junior Heavyweight Inter-School Boxing Championship of the Southeast|Dudley_Dursley%27s_opponent_for_the_Junior_Heavyweight_Inter-School_Boxing_Championship_of_the_Southeast
Hermione Granger's parents|Hermione_Granger%27s_parents
E. Howsom|E._Howsom
J. Murrey|J._Murrey
Non-magic people|Non-magic_people
Rosenbaum|Rosenbaum
Unidentified 2000s Hogwarts student's parents|Unidentified_2000s_Hogwarts_student%27s_parents
E. Wheeler|E._Wheeler
American plumbers|American_plumbers
Muggle at Circus|Muggle_at_Circus
Two unidentified Muggles who saw the Flying Ford Anglia|Two_unidentified_Muggles_who_saw_the_Flying_Ford_Anglia
Unidentified five Muggles who saw the Flying Ford Anglia|Unidentified_five_Muggles_who_saw_the_Flying_Ford_Anglia
Unidentified old tramp|Unidentified_old_tramp
F. Lestrange|F._Lestrange
R. Lestrange|R._Lestrange
Pure-blood|Pure-blood
Society for the Support of Squibs|Society_for_the_Support_of_Squibs
Squib|Squib
Jacob's American relatives|Jacob%27s_American_relatives
Modesty Barebone's biological siblings|Modesty_Barebone%27s_biological_siblings
Dalai Lama|Dalai_Lama
Tibetan Oracles|Tibetan_Oracles
Aimee|Aimee
Barberus Bragge's advisors|Barberus_Bragge%27s_advisors
Chudley Cannons groundskeeper|Chudley_Cannons_groundskeeper
Maximilian Crowdy's children|Maximilian_Crowdy%27s_children
Gerbold Ollivander's three firwood wand customers|Gerbold_Ollivander%27s_three_firwood_wand_customers
Miranda Goshawk's aunts and uncles|Miranda_Goshawk%27s_aunts_and_uncles
Miranda Goshawk's cousins|Miranda_Goshawk%27s_cousins
Paulopabita|Paulopabita
Hardwin Potter's siblings|Hardwin_Potter%27s_siblings
Blishen (wizard)|Blishen_(wizard)
Screaming Bogey of Strathtully|Screaming_Bogey_of_Strathtully
Unidentified German Minister for Magic in 1926|Unidentified_German_Minister_for_Magic_in_1926
Dumbledore family|Dumbledore_family
Peverell brothers|Peverell_brothers
Peverell family|Peverell_family
James and Lily Potter|James_and_Lily_Potter
Potter family|Potter_family
House of Gaunt|House_of_Gaunt
Higglebottom family|Higglebottom_family
Knighton family|Knighton_family
Barebone family|Barebone_family
Blishen family|Blishen_family
Cole family|Cole_family
Cracknell family|Cracknell_family
Creevey family|Creevey_family
Cresswell family|Cresswell_family
Dehoff family|Dehoff_family
Dursley family|Dursley_family
Entwhistle family|Entwhistle_family
Evans family|Evans_family
Finch-Fletchley family|Finch-Fletchley_family
Finnigan family|Finnigan_family
Granger family|Granger_family
Jonker family|Jonker_family
Kowalski family|Kowalski_family
Lockhart family|Lockhart_family
Mason family|Mason_family
McGonagall family|McGonagall_family
Minerva McGonagall's nieces and nephews|Minerva_McGonagall%27s_nieces_and_nephews
Monk family|Monk_family
McGregor family|McGregor_family
Page family|Page_family
Polkiss family|Polkiss_family
Riddle family|Riddle_family
Roberts family|Roberts_family
Shaw family|Shaw_family
Snape family|Snape_family
Steward family|Steward_family
Thomas family|Thomas_family
Vane family|Vane_family
Wakefield family|Wakefield_family
Warren family|Warren_family
Wolpert family|Wolpert_family
Wright family|Wright_family
Stevenson family|Stevenson_family
Alderton family|Alderton_family
Alton family|Alton_family
Alves family|Alves_family
Bagman family|Bagman_family
Bagshot family|Bagshot_family
Belby family|Belby_family
Bell family|Bell_family
Bellchant family|Bellchant_family
Binns family|Binns_family
Bletchley family|Bletchley_family
Bobbin family|Bobbin_family
Bones family|Bones_family
Boot family|Boot_family
Calderon-Boot family|Calderon-Boot_family
Brand family|Brand_family
Broadmoor family|Broadmoor_family
Angus Buchanan's siblings|Angus_Buchanan%27s_siblings
Buchanan family|Buchanan_family
Calderon family|Calderon_family
Carter family|Carter_family
Cattermole family|Cattermole_family
Chang family|Chang_family
Cloke family|Cloke_family
Cloke Mansion|Cloke_Mansion
Cooper family|Cooper_family
Cram family|Cram_family
Davies family|Davies_family
Dawlish family|Dawlish_family
Dedworth family|Dedworth_family
Delacour family|Delacour_family
Denbright family|Denbright_family
Deverill family|Deverill_family
Diggory family|Diggory_family
Dodderidge family|Dodderidge_family
Doge family|Doge_family
Dowson family|Dowson_family
Dumont family|Dumont_family
Aurlie Dumont|Aur%C3%A9lie_Dumont
Edgecombe family|Edgecombe_family
Farley family|Farley_family
Fawcett family|Fawcett_family
Fenwick family|Fenwick_family
Fieldwake family|Fieldwake_family
Flamel family|Flamel_family
Fletcher family|Fletcher_family
Flitwick family|Flitwick_family
Flume family|Flume_family
Fontaine family|Fontaine_family
Fortescue family|Fortescue_family
Fudge family|Fudge_family
Goldstein family|Goldstein_family
Gore family|Gore_family
Goshawk family|Goshawk_family
Graves family|Graves_family
Grimblehawk family|Grimblehawk_family
Gudgeon family|Gudgeon_family
Hagrid family|Hagrid_family
Haywood family|Haywood_family
Higgs family|Higgs_family
Hitchin family|Hitchin_family
Hobday family|Hobday_family
Hopkins family|Hopkins_family
Horton family|Horton_family
Hufflepuff family|Hufflepuff_family
Hyslop family|Hyslop_family
Jacob's family|Jacob%27s_family
Jenkins family|Jenkins_family
Johnson family|Johnson_family
Jorkins family|Jorkins_family
Kettleburn family|Kettleburn_family
Kevin's family|Kevin%27s_family
Khanna family|Khanna_family
Killick family|Killick_family
King family|King_family
Kneen family|Kneen_family
Krum family|Krum_family
Lee family|Lee_family
Levski family|Levski_family
Lima family|Lima_family
Limus family|Limus_family
Loxias's family|Loxias%27s_family
Lupin family|Lupin_family
MacBoon clan|MacBoon_clan
Macdonald family|Macdonald_family
MacFusty clan|MacFusty_clan
Dominique Maestro|Dominique_Maestro
Maestro family|Maestro_family
Marie family|Marie_family
Mather family|Mather_family
Maxime family|Maxime_family
McClivert clan|McClivert_clan
McCormack family|McCormack_family
McLaggen family|McLaggen_family
Midgen family|Midgen_family
Miller family|Miller_family
Mina family|Mina_family
Montague family|Montague_family
Montgomery family|Montgomery_family
Moon family|Moon_family
Morgan family|Morgan_family
Nettles family|Nettles_family
Noel family|Noel_family
O'Brien family|O%27Brien_family
Oddpick family|Oddpick_family
Ogden|Ogden
Ogden family|Ogden_family
Ollerton family|Ollerton_family
Orpington family|Orpington_family
Parkin family|Parkin_family
Walter Parkin's children|Walter_Parkin%27s_children
Patel family|Patel_family
Patil family|Patil_family
Peakes family|Peakes_family
Pettigrew family|Pettigrew_family
Pickering family|Pickering_family
Picquery family|Picquery_family
Plunkett family|Plunkett_family
Po family|Po_family
Podmore family|Podmore_family
Poke family|Poke_family
Beaufort family|Beaufort_family
Blishwick family|Blishwick_family
Brown family|Brown_family
Crabbe family|Crabbe_family
Fleamont family|Fleamont_family
Gage family|Gage_family
Gamp family|Gamp_family
Goyle family|Goyle_family
Kama family|Kama_family
Leroy family|Leroy_family
Lovegood family|Lovegood_family
MacDougal family|MacDougal_family
Moody family|Moody_family
Mulciber family|Mulciber_family
Perrot family|Perrot_family
Potter memorial|Potter_memorial
Prince family|Prince_family
Abbott family|Abbott_family
Avery family|Avery_family
Bulstrode family|Bulstrode_family
Burke family|Burke_family
Carrow family|Carrow_family
Crouch family|Crouch_family
Fawley family|Fawley_family
Marshall and Lucretia Fawley|Marshall_and_Lucretia_Fawley
Flint family|Flint_family
Greengrass family|Greengrass_family
Black Family Tapestry|Black_Family_Tapestry
House of Black|House_of_Black
Break-in of Gringotts Wizarding Bank (1998)|Break-in_of_Gringotts_Wizarding_Bank_(1998)
Doubling Charm|Doubling_Charm
Flagrante Curse|Flagrante_Curse
Gouging Spell|Gouging_Spell
Lestrange Vault|Lestrange_Vault
Thief's Downfall|Thief%27s_Downfall
Lestrange family|Lestrange_family
Clase Lestrange|C%C3%A9l%C3%A9ase_Lestrange
Euphralde Lestrange|Euphra%C3%AFlde_Lestrange
Flicule Lestrange|F%C3%A9licule_Lestrange
Noza Lestrange (ne Trouche)|Noz%C3%A9a_Lestrange_(n%C3%A9e_Trouche)
Salom Lestrange|Salom%C3%A9_Lestrange
Sotre Lestrange|Sot%C3%A8re_Lestrange
Noza Lestrange|Noz%C3%A9a_Lestrange
Longbottom family|Longbottom_family
Alice and Frank Longbottom|Alice_and_Frank_Longbottom
Macmillan family|Macmillan_family
Malfoy family|Malfoy_family
Nott family|Nott_family
Parkinson family|Parkinson_family
Fabian and Gideon Prewett|Fabian_and_Gideon_Prewett
Rosier family|Rosier_family
Rowle family|Rowle_family
Sacred Twenty-Eight|Sacred_Twenty-Eight
Selwyn family|Selwyn_family
Shacklebolt family|Shacklebolt_family
Shafiq family|Shafiq_family
Slughorn family|Slughorn_family
Travers family|Travers_family
Fred and George Weasley|Fred_and_George_Weasley
Yaxley family|Yaxley_family
Sayre family|Sayre_family
Tremblay family|Tremblay_family
Trouche family|Trouche_family
Urquart family|Urquart_family
Volant family|Volant_family
Pyrites family|Pyrites_family
Quintin family|Quintin_family
Rabnott family|Rabnott_family
Ravenclaw family|Ravenclaw_family
Renshaw family|Renshaw_family
Ross family|Ross_family
Runcorn family|Runcorn_family
Sato family|Sato_family
Scamander family|Scamander_family
Schmidt family|Schmidt_family
Scrimgeour family|Scrimgeour_family
Slinkhard family|Slinkhard_family
Smethwyck family|Smethwyck_family
Smith family|Smith_family
Snowy Owl family|Snowy_Owl_family
Snyde family|Snyde_family
Spudmore family|Spudmore_family
Stretton family|Stretton_family
Stump family|Stump_family
Suzuki family|Suzuki_family
Sykes family|Sykes_family
Tandel family|Tandel_family
Thurkell family|Thurkell_family
Tonks family|Tonks_family
Tremlett family|Tremlett_family
Trigg family|Trigg_family
Tuft family|Tuft_family
Tugwood family|Tugwood_family
Turner family|Turner_family
Tuttle family|Tuttle_family
Twelvetrees family|Twelvetrees_family
Umbridge family|Umbridge_family
Vexmoor family|Vexmoor_family
Vulchanov family|Vulchanov_family
Walker family|Walker_family
Warbeck family|Warbeck_family
The Warlock's family|The_Warlock%27s_family
Warrington family|Warrington_family
Weiss family|Weiss_family
Westenberg family|Westenberg_family
Whittle family|Whittle_family
Wilkins family|Wilkins_family
Wilkinson family|Wilkinson_family
Williams family|Williams_family
Winger family|Winger_family
Wood family|Wood_family
Zabini family|Zabini_family
Flora and Hestia Carrow|Flora_and_Hestia_Carrow
Twins|Twins
Karkaroffs Aide|Karkaroff%E2%80%99s_Aide
Unidentified Gryffindor girl (1993-1994) (II)|Unidentified_Gryffindor_girl_(1993-1994)_(II)
Unidentified girls in the Gryffindor Girls' Dormitory (1993-1994)|Unidentified_girls_in_the_Gryffindor_Girls%27_Dormitory_(1993-1994)
Unidentified Gryffindor girl (1993-1994) (I)|Unidentified_Gryffindor_girl_(1993-1994)_(I)
Circle of Khanna|Circle_of_Khanna
Category:Dumbledore's Army defectors|Category:Dumbledore%27s_Army_defectors
Head Boy or Girl|Head_Boy_or_Girl
Hatstall|Hatstall
Prefect|Prefect
Compartment C|Compartment_C
Slug Club|Slug_Club
Student assistant|Student_assistant
London Five|London_Five
Dementor who searched Harry Potter's compartment|Dementor_who_searched_Harry_Potter%27s_compartment
Unidentified goblin|Unidentified_goblin
Portrait of a skeleton in a top hat|Portrait_of_a_skeleton_in_a_top_hat
Unidentified portrait in Malfoy Manor (III)|Unidentified_portrait_in_Malfoy_Manor_(III)
Gnther the Violent|G%C3%BCnther_the_Violent




